음낭 부종: 음낭 팽창, 음낭 종양, 고환 부어있음, 고환 종양, 고환 부종
근긴장의 이상: 근육 긴장 문제, 근육 긴장 이상, 근육 긴장 이상상태, 근육 긴장 이상증, 근육 긴장 이상증후군
반복적인 동작: 반복 행동, 반복 운동, 반복 동작 패턴, 반복적 행위, 반복적 행동 양식
고환 불쾌감: 고환 통증, 고환 불편감, 고환 불쾌함, 고환 불쾌한 감각, 고환 불편
환청: 귀 소리, 귀울림, 이명, 귀 띠, 귀 소음
코플릭 반점: 눈 가루, 눈 물, 안구 반점, 눈물 반점, 눈 코웨트
멍: 멍청이, 뇌 짓물, 뇌 충격, 뇌 멍, 뇌 혈종
생식기 출혈: 생리 혈, 생리 출혈, 생리 혈액, 생리 혈류, 생리 피
성생활이 힘듦: 성적 무기력, 성욕 감퇴, 성욕 저하, 성욕 부진, 성욕 약화
유방의 과다 성장: 유방 비대증, 유방 비정상 성장, 유방 비정상 발육, 유방 비정상 크기, 유방 비정상 확장
늑막삼출: 뇌수액 샘출, 뇌수액 유출, 뇌수액 분비, 뇌수액 배출, 뇌수액 방출
심실세동: 심장 비정상 리듬, 심장 불규칙 진동, 심장 이상 동작, 심장 이상 발작, 심장 이상 세동
방향감각 상실: 방향감 잃음, 방향감 상실증, 방향감 소실, 방향 인지 상실, 방향감 감소
유루증: 배뇨불능, 방광 문제, 방광 기능 이상, 방광 제어 문제, 방광 기능 저하
요독증: 중독 증상, 중독 반응, 중독 증후군, 중독 증세, 중독 현상
눈부심: 눈이 아픔, 눈이 따가움, 눈이 쑤시고, 눈이 아림, 눈이 환히
지방변: 지방 감소, 지방 감소 현상, 지방 감소증, 지방 축소, 지방 변화
영양 불량: 영양 부족, 영양 실조, 영양 결핍, 영양 공급 부족, 영양 섭취 부족
전신 통증: 온몸 통증, 몸 전체 통증, 온몸이 아프고, 몸이 다 아픔, 온몸이 쑤시고
놀람반사의 약화: 깜짝 놀람 약화, 놀라움 반응 감퇴, 놀람 반사 저하, 깜짝 놀람 쇠약, 놀람 반응 약화
인내심이 부족함: 참을성 부족, 인내심 결핍, 참는 능력 부족, 인내심 부족 상태, 참는 능력 감소
눈의 피로: 눈 피로감, 눈 피로 상태, 눈 피로증후군, 시력 피로, 눈의 피로감 증상
유방 크기의 감소: 유방 소실, 유방 축소, 유방 크기 감소, 유방 줄어듦, 유방 크기 감소증
분출성 구토: 구토 발작, 구토 증상, 구토 발작성, 구토 발생, 구토 증세
말초부종: 말초 조직 부종, 근골격 부종, 말초 부종증상, 말초 조직 부종, 근육 부종
복부경련: 복부 근육 경련, 복부 근육 수축, 복부 근육 증세, 복부 경련 발작, 복부 근육 긴장
염증 장애에 따라 다양: 염증 반응 다양성, 염증 증상 다양성, 다양한 염증 증세, 염증 변이, 염증 현상 다양
배뇨장애: 소변 문제, 소변 제어 어려움, 소변 방출 이상, 배뇨 기능 이상, 소변 배출 문제
혈소판감소: 혈소판 감소증, 혈소판 부족, 혈소판 수 감소, 혈소판 감소 상태, 혈소판 부족증
신부전: 신장 기능 저하, 신장 기능 손상, 신장 기능 약화, 신장 기능 감퇴, 신장 기능 부전
괄약근 기능 이상: 짧은 근육 이상, 괄약근 기능 장애, 괄약근 이상 동작, 짧은 근육 이상증, 괄약근 이상 증세
수정체 이상: 관절 이상, 관절 기능 이상, 관절 문제, 관절 이상증, 관절 이상 상태
피가 정액에 나옴: 정액에 혈이 섞임, 정액에 혈관이 나옴, 정액 혈관 출혈, 정액 혈변, 정액 혈혈전
반신마비: 절반 몸 마비, 반쪽 마비, 절반 마비, 허반 마비, 반쪽 마비증
피부소양감: 피부 무감각, 피부 감각 상실, 피부 둔감, 피부 무감각증, 피부 감각 부족
남성스러운 목소리: 남성적 목소리, 남성스러운 음성, 남성 음색, 남성 스타일 목소리, 남성적 음성 톤
엉덩이 통증: 엉덩이 아픔, 엉덩이 따가움, 엉덩이 통증 증세, 엉덩이 불편감, 엉덩이 통증 발생
무릎 부위 통증: 무릎 아픔, 무릎 따가움, 무릎 통증 증세, 무릎 불편감, 무릎 통증 발생
읽기 자체의 문제: 독해 곤란, 문장 해독 어려움, 글씨 해독 곤란, 문장 이해 어려움, 글씨 해석 문제
턱의 통증: 턱 아픔, 턱 통증, 턱 근육통, 턱 관절통, 턱 불편감
몽유병: 잠식병, 수면 장애, 수면 부조화, 수면 문제, 잠 부족
무도증: 균형 장애, 몸 조절 장애, 운동 제어 문제, 불안정한 자세, 균형 감각 상실
함몰유두: 유두 감소, 젖꼭지 침하, 유두 내충출, 유두 침하, 젖꼭지 내포
무산소 발작: 호흡 곤란, 호흡 마비, 숨 막힘, 질식 발작, 호흡 공허감
감각 이상: 감각 이상증, 감각 장애, 감각 손상, 감각 변화, 감각 부조화
고막에 수포형성:고막 물집,고막에 물집 생김,고막에 수포,고막에 물집 형성,고막의 물집
쇼크:충격,급격한 반응,쇼크 상태,심한 충격,몸의 충격
저혈압:낮은 혈압,혈압 저하,혈압이 낮음,혈압 떨어짐,혈압 감소
색깔이 퇴색해보임:색이 바램,색이 흐려짐,색이 탈색됨,색이 빠짐,색이 옅어짐
수막자극증상:수막염 증상,뇌수막 증상,수막 자극 증상,수막의 증상,수막 자극 반응
생리불순:불규칙한 생리,생리 주기 불규칙,생리 이상,생리 불규칙,생리 문제
노란 이물질:노란 분비물,황색 이물질,노란 물질,노란 찌꺼기,황색 분비물
근력 약화:근육 힘 약화,근력 저하,근육 약화,근육 힘 없음,근력 감소
오리걸음:뒤뚱거림,걷기 불편,뒤뚱뒤뚱 걸음,걷는 모습 이상,뒤뚱거리는 걸음
손상 부위 통증:상처 통증,다친 부위 아픔,상처 아픔,부상 부위 통증,부위 통증
코골이:코를 곬음,수면 중 코골이,자는 동안 코를 곬음,잠잘 때 코골이,코 고는 소리
얼굴모양변화:얼굴 변화,얼굴형 변함,얼굴 모양 달라짐,얼굴 변형,얼굴 모습 변함
질식:숨막힘,질식 증상,숨막히는 느낌,숨쉬기 어려움,호흡곤란
태아의 하강감:아기 내려옴,태아 내려옴,태아 하강 느낌,아기 하강,태아 위치 변화
급성 신부전:급성 신장 문제,신장 기능 상실,급성 신장 부전,신장 기능 저하,급성 신장 장애
수면 유지가 어려움:잠 유지 어려움,자다 깸,수면 유지 문제,깨어나는 잠,잠 못 지속
비관주의:부정적 생각,비관적 태도,부정적 사고,낙담,비관적 시각
림프절 농양:림프절 고름,림프절 염증,림프절 부기,림프절에 고름,림프절 감염
천명음:쌕쌕거림,호흡음 이상,숨쉴 때 소리,쌕쌕거리는 소리,호흡음
이슬:임신 말기 분비물,출산 전 분비물,출산 준비 분비물,임신 마지막 분비물,출산 전 증상
털이 동반되기도 함:털이 나기도 함,털이 자라기도 함,털이 생기기도 함,털 동반 증상,털이 나타나기도 함
약시:시력 저하,약한 시력,시력이 약함,약한 눈,시력 감소
삶에 대한 흥미 상실:무기력증,삶의 재미 없음,활력 상실,의욕 상실,무기력함
요관 폐쇄:소변길 막힘,소변 배출 어려움,요관 막힘,소변길 폐쇄,요관 문제
식후 불쾌감:식사 후 불편함,밥 먹고 불쾌,식후 속 불편,먹고 난 뒤 불쾌,밥 먹고 나서 불편
치아발달장애:치아 발육 문제,치아 성장 이상,치아 발달 문제,치아 성장 저하,치아 발육 장애
다발성 장기부전 증상:여러 장기 기능 상실,장기 부전 증상,장기 여러 개 기능 저하,다수 장기 문제,장기 기능 저하
새가슴:흉부 돌출,가슴이 튀어나옴,돌출된 가슴,가슴뼈 돌출,튀어나온 가슴
치아 흔들림:흔들리는 이,치아가 흔들림,헐거운 치아,치아 움직임,흔들리는 치아
콧물:코에서 나오는 물,흐르는 콧물,콧물이 남,코 분비물,맑은 콧물
감기 증상:감기 기운,감기 같은 증상,감기 느낌,감기 증세,감기 기운 있음
복부의 박동감:배에서 느껴지는 박동,배의 맥박,복부 뛰는 느낌,배가 뛰는 느낌,배에서 느껴지는 맥박
굽은 등:등이 구부러짐,등 굽음,굽은 허리,구부정한 등,등이 굽어짐
신경 마비:신경 기능 상실,신경 마비 증상,신경 손상,신경 저하,신경 무기력
이마가 넓어짐:넓어진 이마,이마가 커짐,넓어진 이마 부위,이마 확장,넓어진 이마 선
실인증:인식 불능,인식 장애,실인증 증상,알아보지 못함,인식 못함
관절잡음:관절 소리,관절에서 나는 소리,관절 소음,관절음,관절서 소리 남
관절 운동성 감소:관절 운동 어려움,관절 운동 저하,관절 움직임 감소,관절 유연성 감소,관절 움직임 저하
저체온:체온 저하,낮은 체온,몸이 차가워짐,체온 떨어짐,냉각된 몸
불임:임신 불가,아이 못 가짐,임신 어려움,출산 불가,임신 불능
통증 없는 부종:아프지 않은 부종,무통 부종,통증 없는 붓기,아프지 않은 붓기,무통성 부종
이완성 마비:근육 이완 마비,근육 늘어짐,이완된 마비,힘 빠진 마비,늘어진 마비
구취:입 냄새,입에서 나는 냄새,입 악취,구강 냄새,입안 냄새
겨드랑이 악취:겨드랑이 냄새,겨드랑이에서 악취,겨드랑이 냄새 남,겨드랑이 악취 발생,겨드랑이 악취 풍김
다리변형:다리 모양 변형,변형된 다리,다리의 이상,다리 기형,다리 형태 변형
추위를 못견딤:추위에 약함,추위 못 참음,추위 민감,추위에 예민,차가운 것 못 견딤
손 발톱이 두꺼워짐:두꺼운 손톱,발톱이 두꺼워짐,손톱 두꺼워짐,발톱 두꺼워짐,손발톱이 두꺼워짐
옷 액와 부분 변색:옷 겨드랑이 부분 색 바램,옷 겨드랑이 부분 탈색,겨드랑이 부분 색 변화,겨드랑이 부분 변색,옷 겨드랑이 부분 색 변함
삼키기 곤란:삼키기 어려움,목넘김 어려움,음식 삼킴 곤란,삼킬 때 아픔,음식 삼키기 힘듦
안구혼탁:흐린 눈,혼탁한 눈,눈이 뿌옇게 보임,뿌연 시야,혼탁한 시력
사지 부종:팔 다리 붓기,사지 붓기,팔과 다리 부음,팔다리 부종,사지 부어오름
근위축:근육 감소,근육 줄어듦,줄어든 근육,약해진 근육,근육 축소
설염:혀 염증,혀의 염증,혀 염증 증상,염증성 혀,혀의 통증
입 주변 부종:입가 붓기,입 주위 부음,입 주변 붓기,입가 부종,입 주위 부종
체중감소:살 빠짐,몸무게 감소,체중 줄어듦,몸무게 줄어듦,체중 감량
피로감:피곤함,지침,기운 없음,피곤한 느낌,피로 증상
에너지가 적음:힘 빠짐,기운 없음,활력 저하,에너지 부족,기운 빠짐
곤봉지:손가락 끝 굵어짐,굵어진 손가락 끝,손가락 모양 변화,둥근 손가락 끝,두꺼운 손가락 끝
비정상적인 움직임:이상한 움직임,비정상적 동작,특이한 움직임,비정상적 행동,이상한 동작
사고의 비약:생각의 도약,빠른 사고,급격한 사고,사고의 빠름,비약적 생각
전신 부종:온몸 붓기,전신 부음,온몸 부종,전신 붇기,몸 전체 부음
식욕부진:식욕 없음,입맛 떨어짐,밥맛 없음,먹기 싫음,입맛 저하
격동적 움직임:빠른 동작,격렬한 움직임,격한 움직임,빠른 움직임,급격한 동작
상처가 넓어짐:확대된 상처,커진 상처,상처 부위 넓어짐,넓어진 상처,상처 확장
피부색 변화:피부색 변함,변색된 피부,피부색 달라짐,변한 피부색,피부 변색
비정상적인 진통:이상한 진통,비정상적 통증,특이한 통증,비정상적 아픔,진통 문제
피부 긴장도 저하:처진 피부,늘어진 피부,피부 탄력 저하,탄력 없는 피부,늘어지는 피부
노출증:노출증상,공개증,공개행동,공개적 행동,노출 문제
구강호흡:입으로 숨쉬기,입호흡,코 대신 입으로 숨쉬기,입으로 호흡,구강으로 숨쉬기
달모양의 둥근 얼굴:달처럼 둥근 얼굴,둥근 얼굴,달 모양 얼굴,둥근형 얼굴,동그란 얼굴
안구증대:커진 눈,눈 커짐,증가된 안구,안구 커짐,커진 안구
사래걸림:목이 잠김,목에 걸림,사래 걸린 증상,목잠김,목에 걸린 느낌
자세 불안정:불안정한 자세,자세가 불안정함,안정되지 않은 자세,자세 흔들림,불안정한 동작
무호흡:숨 멈춤,호흡 중단,멈춘 호흡,일시적 무호흡,숨 쉬지 않음
척추와 허리 디스크:척추 디스크,허리 디스크,디스크 문제,척추와 허리의 디스크,디스크 장애
치아의 탈락:빠진 치아,빠지는 이,빠짐 치아,이탈 치아,탈락된 치아
축 쳐진 귀:쳐진 귀,늘어진 귀,축 늘어진 귀,축 쳐진 귀 상태,늘어진 귀 모양
염좌:삠,근육 삠,삔 증상,근육 염좌,삐어짐
대인관계 어려움:사람들과 어려움,사회적 관계 문제,대인 문제,인간관계 어려움,대인관계 불편
무뇨:소변 안 나옴,소변 없음,오줌 안 나옴,소변 배출 안 됨,오줌 없음
빈뇨:잦은 소변,자주 소변 봄,소변 횟수 많음,빈번한 배뇨,잦은 배뇨
이중턱:겹턱,이중으로 보이는 턱,겹쳐진 턱,겹겹이 턱,두 겹 턱
반복되는 폐렴:잦은 폐렴,반복적 폐렴,자주 걸리는 폐렴,폐렴 반복,빈번한 폐렴
갈퀴족지:발가락 붙음,붙은 발가락,연결된 발가락,붙어 있는 발가락,붙어 있는 발
이상한 소리를 냄:이상한 소리,특이한 소리,비정상적 소리,변한 소리,특별한 소리
표준 신장의 3%이하:작은 키,표준 이하 키,3% 이하 키,작은 신장,아주 작은 키
남성의 여성형 유방:남성의 여성형 가슴,여성형 가슴,여성 같은 가슴,여성형 남성 가슴,남성의 유방 확대
어깨 움직임의 제한:어깨 제한,어깨 움직임 어려움,제한된 어깨 움직임,어깨 움직임 감소,어깨 제한 동작
감정 변화:변한 감정,변동 감정,감정 변동,감정 달라짐,달라진 감정
폐부종:폐 붓기,부은 폐,폐의 부종,폐가 붓는 증상,폐 부풀어 오름
얼굴 한쪽의 반점:한쪽 얼굴 반점,얼굴에 생긴 반점,얼굴 한쪽에 점,얼굴 반쪽 반점,얼굴 점
고막 충혈:충혈된 고막,붉어진 고막,고막의 충혈,붉은 고막,고막 빨개짐
뇌수종:수두증,뇌에 물참,뇌의 물참,뇌에 물이 참,뇌수종 증상
눈 사이가 멀어보임:멀어 보이는 눈,넓어진 눈 간격,눈 사이 넓어짐,멀어진 눈 사이,넓은 눈 간격
성선 기능 저하증:성선 기능 저하,성선 기능 감소,성선 문제,성선 저하 증상,성선 저하
자궁 수축:자궁의 수축,수축된 자궁,자궁 수축 증상,자궁이 수축됨,자궁이 오므라듦
펴진 귓바퀴:펴진 귀,펴진 귀 모양,펼쳐진 귀,펼쳐진 귓바퀴,펼쳐진 귀 모양
경부 림프절병증:목 림프절 병증,목 림프절 이상,목의 림프절 문제,목 림프절 병,목 림프절 장애
질병에 대한 공포:병에 대한 두려움,병 공포,질병 두려움,질병 공포증,병에 대한 공포증
가슴 쓰림:가슴 통증,가슴 쓰라림,가슴 아픔,가슴이 쓰라림,가슴의 통증
신증후군:신장 증후군,신장의 문제,신장 이상,신증후군 증상,신장의 장애
열감:뜨거운 느낌,열이 남,더운 느낌,몸의 열기,뜨거운 몸
고음에서의 분열:고음에서 갈라짐,고음 갈라짐,높은 소리에서 분열,고음에서 깨짐,높은 소리 분열
담석:쓸개돌,담낭 결석,담낭 돌,쓸개 결석,담낭에 생긴 돌
심근손상:심장 근육 손상,손상된 심근,심근 파열,심장 근육 문제,심근 문제
정서장애:정신적 문제,정신적 장애,정서적 문제,정신 문제,정서 장애
다리의 길이가 틀림:다리 길이 차이,다리 길이 불일치,다리 길이 다름,비대칭 다리,길이가 다른 다리
면포:블랙헤드,피지 덩어리,피부 면포,작은 여드름,피지 축적
두피 건조:건조한 두피,마른 두피,건조한 머리 피부,두피 수분 부족,마른 두피 상태
낮은 자존감:자존감 저하,자존감 없음,낮은 자신감,자존감 부족,자신감 저하
4 5번째 손가락 굽음:손가락 굽음,굽은 손가락,손가락 휘어짐,손가락 구부러짐,굽은 네번째 다섯번째 손가락
발진:피부 발진,뾰루지,피부 트러블,붉은 반점,피부 병변
충동 조절 어려움:충동 제어 불가,충동적 행동,충동 못 참음,충동 문제,충동 조절 문제
거칠어진 피부:거친 피부,거칠거칠한 피부,불규칙한 피부,거친 감촉,까칠한 피부
부정교합:맞물림 이상,치아 교합 문제,교합 불일치,맞지 않는 교합,교합 문제
간기능 저하:간 기능 저하,간의 기능 약화,간 약화,간 기능 문제,약해진 간
거품있는 소변:거품 소변,거품 생기는 소변,거품나는 오줌,거품 나는 소변,거품이 있는 소변
눈꺼풀의 떨림:눈 떨림,눈꺼풀 경련,눈의 떨림,떨리는 눈꺼풀,눈꺼풀 움직임
소아기호증:어린이 성애,아동 성애,어린이 선호,소아 성애,어린이 사랑
심정지:심장 멈춤,심장 정지,멈춘 심장,심장 기능 멈춤,정지된 심장
면역기능 이상:면역 문제,면역 기능 저하,면역 저하,면역력 문제,면역력 저하
피부 및 점막의 염증:피부 염증,점막 염증,피부 점막 염증,염증 증상,염증 발생
중심시력감소: 시력 저하, 중심 시야 손실, 시야 흐림, 눈의 시력 약화, 중심 시야 장애
미소음경(micropenis): 작은 음경, 미세 음경, 음경 크기 감소, 음경이 작음, 음경 크기 문제
배꼽이 솟음: 튀어나온 배꼽, 배꼽 돌출, 융기된 배꼽, 솟아오른 배꼽, 배꼽의 돌출현상
눈 주위 노란 반점: 눈 주변 황색반, 눈가의 노란 반점, 눈 주위 황반, 눈 옆 노란 점, 눈가 황색 점
장폐색: 장의 막힘, 장 통과 장애, 장이 막힘, 소화관 폐쇄, 장의 폐쇄 현상
눈의 자극감: 눈 따가움, 눈 자극, 눈의 불편감, 눈이 쓰림, 눈의 화끈거림
저체중: 체중 감소, 몸무게 부족, 마른 체형, 저체중 상태, 몸무게 저하
흉수: 가슴 물참, 흉부 액체, 흉강의 물참, 가슴에 물, 흉부의 액체 축적
분홍색의 반흔: 핑크빛 흉터, 분홍 반점, 분홍 흉터, 핑크 자국, 분홍색 상처 자국
관절염: 관절 염증, 관절 통증, 관절 질환, 관절 붓기, 관절의 염증
비장비대: 비장의 커짐, 비장 부풀어 오름, 비장 비대증, 비장이 커짐, 비장의 확장
망막 이상: 망막 문제, 망막 손상, 망막 질환, 눈 망막 장애, 망막의 이상
왜곡된 신체상: 신체 이미지 왜곡, 몸에 대한 왜곡된 인식, 왜곡된 신체 인식, 신체상 문제, 잘못된 신체 인식
무월경: 생리 없음, 월경 중단, 생리 중지, 무 생리, 월경 멈춤
종아리 근육의 비대: 종아리 근육 커짐, 종아리 근육 비대증, 종아리 두꺼움, 종아리 근육 발달, 종아리 근육 확대
수면 주기의 변화: 수면 패턴 변화, 잠 패턴 변화, 수면 리듬 변화, 잠 주기 변화, 수면 시간 변화
마비: 움직임 불가, 신체 마비, 몸이 마비됨, 마비 상태, 신체의 마비
가늘어지는 팔다리: 팔다리의 얇아짐, 팔 다리 가늘어짐, 팔다리 살 빠짐, 팔다리 약해짐, 팔다리 체중 감소
성기크기 감소: 성기 크기 저하, 성기 작아짐, 성기 축소, 성기의 감소, 성기 사이즈 줄어듬
성기능 장애: 성기능 문제, 성적 문제, 성기능 저하, 성적 장애, 성생활 문제
폐출혈: 폐에서 출혈, 폐의 피, 폐 출혈, 폐 피 흐름, 폐 내부 출혈
사회성 부족: 사회적 고립, 사회성 문제, 사람들과의 거리감, 사회적 상호작용 부족, 사회적 고립감
축 늘어짐: 힘 빠짐, 축 처짐, 힘이 없음, 축 늘어진 상태, 신체의 무기력
진한 소변색: 짙은 소변, 어두운 소변색, 소변이 진함, 어두운 소변, 진한 색의 소변
음식섭취 거부: 먹기 싫어함, 음식 거부, 식사 거부, 먹지 않음, 음식 섭취를 피함
빈혈: 혈액 부족, 피가 부족함, 혈액의 빈혈, 적혈구 부족, 혈액의 문제
혀끝이 w모양: 혀끝의 이상, 혀끝 변형, w자 혀끝, 혀끝 모양 변형, 혀끝 이상
폐동맥 고혈압: 폐동맥 압력 상승, 폐동맥 혈압 증가, 폐동맥의 고혈압, 폐의 혈압 상승, 폐혈관 고혈압
요도가 아랫쪽에 위치: 요도의 위치 문제, 요도가 아래쪽, 요도의 비정상적 위치, 하부 요도, 요도 위치 이상
안구돌출: 눈이 튀어나옴, 돌출된 눈, 안구의 돌출, 눈알 돌출, 눈의 튀어나옴
합지증: 손가락이 붙음, 합쳐진 손가락, 손가락이 연결됨, 손가락 합체, 손가락 융합
정체감 혼란 및 변형: 정체감 문제, 자아 혼란, 정체성 문제, 정체감의 변형, 자아 인식 혼란
잦은 감염: 반복적 감염, 빈번한 감염, 자주 걸리는 감염, 반복 감염, 자주 걸리는 병
조절할 수 없는 충동감: 충동 조절 문제, 억제 불가능한 충동, 충동 조절 불능, 통제 안 되는 충동, 억제할 수 없는 충동
호흡곤란: 숨쉬기 어려움, 숨이 참, 숨쉬기 힘듦, 호흡 어려움, 호흡의 문제
말을 많이 함: 다변, 말이 많음, 말 많음, 다작, 과도한 말
안구 이상: 눈의 문제, 안구 문제, 눈 장애, 안구 이상증, 시각 기관 문제
흉쇄 유돌근의 몽우리: 목 근육 결림, 흉쇄근 결림, 목덩이, 목의 몽우리, 유돌근의 결림
졸림: 졸음, 잠옴, 졸린 상태, 피곤함, 잠오는 느낌
혀의 통증: 혀 아픔, 혀의 아픔, 혀가 쑤심, 혀의 불편감, 혀 통증
천식: 숨 가쁨, 기도 협착, 천식 증상, 숨쉬기 어려움, 천식 발작
설사: 물설사, 잦은 설사, 배탈, 장 트러블, 설사증
편측 사지의 감각소실: 한쪽 팔다리 감각 없음, 편측 신경 마비, 편측 감각 소실, 한쪽 팔다리의 감각 문제, 편측 감각 장애
트림: 공기뱉기, 트림하기, 공기 배출, 트림현상, 트림 나옴
가학증: 고통 주기 즐김, 고통 유발 성향, 가학 성향, 고통 주는 성향, 가학적 행동
손 발 감각 저하: 손발 저림, 손발 감각 무뎌짐, 손발의 감각 저하, 손발의 둔감, 손발 저림 현상
눈 주변 부종: 눈 주위 부음, 눈가 부종, 눈 주변 붓기, 눈 주위 붓기, 눈 주위 부풀어오름
회음부의 작은 돌기: 회음부 돌기, 회음부의 작은 혹, 회음부 작은 종양, 회음부의 작은 튀어나옴, 회음부 돌출
저심박출량: 낮은 심박출량, 심장 펌프 문제, 심박출 감소, 심장의 펌프 능력 저하, 심박출 저하
안검하수: 눈꺼풀 처짐, 눈꺼풀 하수, 처진 눈꺼풀, 눈꺼풀 내려옴, 눈꺼풀의 처짐
무의지증: 무기력증, 의지 상실, 무동력증, 동기 부여 안됨, 동기 결여
압통: 누르면 아픔, 눌림 통증, 압박 시 통증, 눌리면 아픈, 압박 통증
객혈: 피가래, 피 섞인 가래, 혈액 가래, 가래에 피, 피 뱉음
아나필락시스: 알레르기 쇼크, 과민반응, 아나필락틱 쇼크, 급성 알레르기 반응, 아나필락시스 반응
호르몬변화: 호르몬 변동, 호르몬 변화증, 호르몬 변이, 호르몬 불균형, 호르몬 변화 현상
산통: 출산 통증, 진통, 분만 고통, 출산의 고통, 출산 통증
어깨근육 약화: 어깨 힘 빠짐, 어깨 근력 저하, 어깨 근육 힘 없음, 어깨 근육 약화, 어깨의 힘 부족
분만 지연: 출산 지연, 분만 늦어짐, 출산 늦어짐, 출산 시간 지연, 분만 시기 지연
탈력발작: 갑작스러운 무력감, 힘 빠짐 발작, 기력 소진 발작, 탈진 발작, 근력 소실 발작
희망이 없는 느낌: 절망감, 희망 상실, 낙담, 희망 없음, 좌절감
구토: 토함, 토하기, 메스꺼움, 토하는 증상, 위액 역류
항문 통증: 항문 아픔, 항문 불편감, 항문 통증, 항문 쑤심, 항문이 아파요
붉고 얇은 피부: 홍조 피부, 얇은 피부, 붉어진 피부, 얇고 빨간 피부, 얇아진 피부
배뇨 시 통증: 소변 볼 때 아픔, 소변 시 통증, 배뇨 중 불편감, 소변 때 아픔, 소변 시 아픔
점상 출혈: 작은 출혈점, 피부의 작은 출혈, 점 모양 출혈, 피부의 점상 혈점, 작은 피출혈
음낭이 잘 발달하지 않음: 음낭 발달 부족, 음낭 미발달, 음낭이 작음, 음낭 크기 문제, 음낭 발육 부진
무관심: 관심 없음, 무심함, 냉담함, 흥미 부족, 무감각
구각염: 입가 염증, 입가의 염증, 입 주위 염증, 입술 염증, 구석염
소변량 감소: 소변 적음, 소변 줄어듦, 소변량 줄어듦, 소변 적게 나옴, 소변 양 감소
관련 장기의 일시적 기능장애: 장기 기능 일시 장애, 장기 기능 문제, 장기 기능 저하, 장기 기능 일시 저하, 관련 장기 문제
자반증: 피부 자반, 자반점, 자색반점, 피부 출혈, 자색 출혈
출혈 경향성: 출혈 쉽게 됨, 출혈 빈번함, 출혈 잘 됨, 출혈 성향, 출혈 잦음
입수면기의 환각: 잠들기 전 환각, 수면 전 환각, 수면기 환각, 잠 전 환각, 수면 입면기 환각
뻣뻣함: 경직됨, 굳음, 뻣뻣해짐, 몸이 경직됨, 근육 경직
광과민성: 빛에 민감함, 광민감증, 빛에 예민함, 빛에 약함, 빛 반응 과민
코가 삐뚤어짐: 코 비틀림, 코 휘어짐, 비뚤어진 코, 코 모양 변형, 휜 코
거짓 증상 호소: 허위 증상, 가짜 증상, 위증상, 거짓 아픔, 증상 가장
모발 탈색: 머리 탈색, 머리 색 빠짐, 머리카락 탈색, 머리색 변화, 머리카락 색 빠짐
관절 구축: 관절 경직, 관절 굳음, 관절 고정, 관절 뻣뻣함, 관절의 경직
뇌압상승증상: 두개내압 상승, 뇌압 증가, 두개내압 상승 증상, 뇌압 고압, 두개내압 고혈압
발 안쪽 아치의 소실: 평발, 발 아치 소실, 발 아치 없음, 발 아치 무너짐, 평평한 발
거대자궁: 큰 자궁, 자궁 비대, 비대한 자궁, 자궁 크기 증가, 커진 자궁
잔변감: 잔변 느낌, 배변 불완전감, 배변 후 잔변감, 배변 후 찝찝함, 잔변 증상
수면 중 소변을 봄: 야뇨증, 잠 중 소변, 밤에 소변, 수면 중 방뇨, 수면 야뇨
무의식: 의식 없음, 깨어나지 않음, 무의식 상태, 의식 불가, 의식 잃음
행동장애: 행동 문제, 행동 이상, 행동 통제 불가, 비정상적 행동, 행동장애 증상
음성피로: 목소리 피로, 음성 피로감, 목소리 피곤함, 목소리 피곤증, 음성 피로 증상
폭식: 과식, 폭음, 지나친 먹기, 폭식 증상, 많이 먹기
환부 냉감: 부위 차가움, 냉각 부위, 차가운 상처, 냉기 부위, 상처 부위 차가움
주먹을 쥐기 힘듬: 손 꽉 쥐기 어려움, 손 쥐기 힘듦, 주먹 쥐기 어려움, 손잡기 힘듦, 주먹 쥐는 것 힘듦
열: 고열, 체온 상승, 열기, 고온, 발열
이성의 옷을 착용함: 이성 옷 입기, 반대 성별 옷 착용, 이성 복장, 이성복 착용, 이성의복 착용
각막 이상: 각막 문제, 각막 손상, 각막 질환, 각막 장애, 각막의 이상
치핵의 탈출: 치질 탈출, 항문 치핵, 치핵 돌출, 치핵 탈락, 항문 탈장
가슴 통증: 흉통, 가슴 아픔, 흉부 통증, 가슴 불편함, 흉부 아픔
하지 마비: 다리 마비, 하반신 마비, 다리 움직임 불가, 하반신 불편함, 하체 마비
소화불량: 소화 문제, 소화 안됨, 소화 불편함, 소화기 장애, 소화 곤란
실명: 시력 상실, 눈 안보임, 눈 멈춤, 시력 잃음, 시각 장애
생식기 통증: 성기 아픔, 성기 통증, 생식기 불편함, 성기 불편감, 생식기 고통
황반부종: 황반 붓기, 눈 황반 부종, 눈의 부종, 황반의 부기, 눈 황반 부음
적색의 각질화된 피부: 빨간 각질 피부, 붉은 각질 피부, 각질화된 붉은 피부, 각질화된 적색 피부, 붉어진 각질
암 부위별로 다름: 부위별 암 증상, 암의 부위별 차이, 암 증상 다양, 암의 부위별 증상, 부위에 따른 암 증상
점막변화: 점막 이상, 점막 손상, 점막 문제, 점막 변화 증상, 점막의 변화
자제력 상실 두려움: 자제력 상실 공포, 통제 불능 두려움, 자제력 잃을까 두려움, 통제력 상실 두려움, 자제력 문제 공포
병적골절: 병적 골절, 비정상적 골절, 골절 문제, 골절 이상, 뼈 부러짐
갈색 피부 반점: 갈색 반점, 피부 갈색점, 갈색 반점 피부, 피부의 갈색 반점, 갈색 피부 점
혼수: 혼수 상태, 의식 불명, 혼미, 혼수 증상, 의식 상실
굳은 살: 굳은살, 피부 경화, 피부 굳음, 굳어진 살, 피부 두꺼워짐
화농성 객담: 고름 가래, 화농 가래, 고름 섞인 가래, 화농성 기침, 화농성 점액
납작한 코: 편평한 코, 눌린 코, 코 납작함, 납작해진 코, 코 모양 납작
지속 발기: 발기 지속, 발기 문제, 장시간 발기, 발기 불능, 발기 유지
판단력장애: 판단 문제, 판단력 저하, 판단력 상실, 결정 능력 문제, 판단력의 이상
무맥: 맥박 없음, 맥박 소실, 맥박 안 잡힘, 맥박 상실, 맥박 측정 불가
열수: 열기 있는 땀, 땀 분출, 더운 땀, 열 난 땀, 뜨거운 땀
잇몸염증: 잇몸 염증, 잇몸 부기, 잇몸 통증, 잇몸 질환, 잇몸의 붓기
수면 마비: 잠 마비, 수면 중 마비, 잠 중 마비, 수면 무력감, 잠 마비 상태
반점: 피부 반점, 반점 증상, 반점 질환, 피부의 반점, 작은 반점
빈호흡: 빠른 호흡, 얕은 호흡, 빈번한 호흡, 호흡 급함, 빠른 숨
부분적 음순융합: 음순 부분 융합, 음순 융합, 음순 결합, 음순 붙음, 음순의 융합
탈수: 수분 부족, 체액 부족, 탈수 증상, 수분 결핍, 탈수 상태
긴박뇨: 갑작스런 소변 욕구, 급한 소변, 소변 참기 어려움, 갑작스런 배뇨 욕구, 긴급 배뇨
경련: 근육 경련, 근육 떨림, 경련 증상, 근육의 경련, 떨림 현상
장마비: 장기 마비, 소화기관 마비, 장의 마비, 소화 불능, 장기능 마비
문맥성고혈압: 간문맥 고혈압, 간문맥 혈압 증가, 간 혈압 상승, 간문맥 압력 상승, 간 혈압 문제
흥분: 고양감, 격양, 신남, 들뜸, 흥분 상태
이폐색감: 귀 막힘, 귀가 꽉 찬 느낌, 귀가 막힌 느낌, 귀가 먹먹함, 귀의 폐쇄감
섬망: 혼란, 착란, 정신 혼미, 섬망 상태, 혼동
어지러움: 현기증, 어지럼증, 어지러움 증상, 빙글빙글 돌음, 어지러움 상태
시림: 추위 느낌, 차가움, 냉기, 서늘함, 시린 느낌
발육부전: 성장 부진, 발달 지연, 성장 장애, 발육 장애, 성장 문제
눈꺼풀 처짐증: 눈꺼풀 하수, 눈꺼풀 쳐짐, 처진 눈꺼풀, 안검하수, 눈꺼풀 내려옴
눈비빔: 눈 비비기, 눈 비빔 증상, 눈 가려움, 눈 간지러움, 눈 문지름
말더듬: 말더듬증, 말 막힘, 언어 장애, 더듬는 말, 말 더듬기
흉부압박감: 가슴 답답함, 흉부 불편감, 가슴 조임, 가슴 압박, 흉부 압박
임신중 배의 크기가 줄어듦: 임신 중 배 작아짐, 임신 중 배 감소, 임신 배 줄어듦, 임신 배 크기 변화, 임신 중 배 크기 감소
정서 및 행동의 일탈: 정서적 불안정, 행동 문제, 정서 장애, 행동 일탈, 정서 불안정
태동의 위치 이상: 태아 위치 문제, 태아 위치 이상, 태아 위치 변동, 비정상적 태동 위치, 태동 위치 변화
수면장애: 불면증, 잠 문제, 수면 문제, 수면 곤란, 잠 장애
저작장애: 씹기 어려움, 씹기 문제, 저작 불편감, 씹기 장애, 저작 문제
경직: 근육 경직, 몸이 굳음, 경직 상태, 근육 뻣뻣함, 몸의 경직
무감각: 감각 상실, 느낌 없음, 감각 둔함, 무감각 상태, 감각 저하
손상 부위 출혈: 상처 출혈, 손상 부위 피, 손상 부위의 출혈, 상처의 피, 손상 부위 혈액
심음 감소: 심장 소리 약해짐, 심장음 저하, 심박 소리 감소, 심장 소리 감소, 심음 약해짐
떨림(진전): 몸 떨림, 손 떨림, 떨림 증상, 진전 상태, 근육 떨림
사지의 창백한 현상: 팔 다리 창백, 사지 색 변화, 창백한 사지, 사지 혈색 감소, 사지 창백
산만함: 집중력 저하, 주의 산만, 주의력 문제, 산만 증상, 집중 안됨
탁한 소변: 뿌연 소변, 흐린 소변, 탁해진 소변, 소변 탁함, 흐려진 소변
결막염: 눈 염증, 결막 염증, 눈의 결막염, 결막의 염증, 눈 결막 질환
배꼽의 고름 및 피: 배꼽의 고름, 배꼽 피, 배꼽 염증, 배꼽 고름 증상, 배꼽의 피
근육통: 근육 아픔, 근육통증, 근육의 통증, 아픈 근육, 근육 불편감
무균성 뇌막염: 비감염성 뇌막염, 무균 뇌막염, 비세균성 뇌막염, 무균성 염증, 비감염성 염증
손목에 심한 붓기와 통증: 손목 붓기, 손목 통증, 손목 부종, 아픈 손목, 손목 부음
괴사: 조직 죽음, 조직 괴사, 세포 괴사, 조직 손상, 세포 죽음
우유부단함: 결단력 부족, 망설임, 결단력 없음, 우유부단한 상태, 결단 못함
골절: 뼈 부러짐, 뼈 골절, 골절 상태, 부러진 뼈, 골절 증상
기운없음: 무기력, 피곤함, 에너지 부족, 무력감, 힘 없음
발음 이상: 말하기 문제, 발음 문제, 말 더듬, 발음 장애, 발음 불편
질의 건조함: 질 건조증, 질 건조, 건조한 질, 질의 불편감, 질의 건조 증상
손의 통증: 손 아픔, 손 통증, 손이 아파요, 손 불편함, 손 쑤심
고정된 믿음: 고집, 신념 고수, 믿음 고정, 견고한 신념, 바뀌지 않는 생각
고환 위축: 고환 작아짐, 고환 크기 감소, 고환 축소, 고환 위축 증상, 고환 크기 저하
질투: 시기, 질투심, 부러움, 질투하는 마음, 질투감
복벽이 움푹 들어감: 배 벽 꺼짐, 복부 움푹, 배가 꺼짐, 배가 들어감, 복부 함몰
코의 기형 동반: 코 변형, 코 기형, 코 모양 이상, 코 형태 변형, 비정상적 코 모양
오후 우울감 완화: 오후 우울감 감소, 오후 기분 나아짐, 오후 우울 덜함, 오후 우울증 완화, 오후 기분 좋아짐
다른 선천성 기형: 다른 선천적 결함, 다른 선천적 이상, 다른 선천성 이상, 추가 선천성 기형, 추가 선천적 문제
청색증: 피부 파래짐, 청색 반점, 혈액 산소 부족, 청색 피부, 산소 결핍 증상
심부전: 심장 기능 저하, 심장 기능 상실, 심장 기능 부전, 심장 문제, 심장 기능 장애
다음: 갈증, 목마름, 물 마시고 싶음, 갈증 증가, 갈증 심함
손마디가 뻣뻣해짐: 손가락 경직, 손가락 뻣뻣함, 손가락 굳음, 손가락 움직임 어려움, 손가락 경직증
치아 통증: 치통, 이 아픔, 치아의 아픔, 이 통증, 치아 불편감
울혈성 심부전: 심장 울혈, 심장 울혈증, 심부전 울혈, 심장 울혈 상태, 울혈성 심장 기능 저하
온몸의 잔털: 체모 증가, 몸에 잔털, 잔털 많이 남, 잔털 증식, 잔털 발생
환부 부종: 부은 상처, 부은 부위, 붓기, 상처 부위 부종, 부은 환부
주변시야손상: 측면 시야 손실, 옆 시야 손상, 주변 시야 문제, 옆 시야 감소, 측면 시야 감소
불규칙적 진통: 간헐적 진통, 불규칙한 아픔, 간헐적 고통, 비정기적 진통, 가끔씩 아픔
수유 곤란: 젖먹이기 어려움, 수유 문제, 젖 주기 어려움, 수유 장애, 수유 불편
난청: 청력 저하, 귀 안들림, 소리 안들림, 청력 상실, 귀먹음
악취: 나쁜 냄새, 고약한 냄새, 냄새 문제, 불쾌한 냄새, 악취 발생
신장 감소: 콩팥 크기 감소, 신장 작아짐, 신장 축소, 신장 크기 줄어듦, 신장 기능 저하
원한: 분노, 복수심, 미움, 악감정, 앙심
불면증: 잠 못 잠, 수면 장애, 잠 문제, 밤에 못 잠, 잠 부족
마찰음: 삐걱 소리, 긁히는 소리, 비비는 소리, 스치는 소리, 마찰 소리
탈장 부위의 통증: 탈장 부위 아픔, 탈장 부위 불편감, 탈장 부위 통증, 탈장 부위 쑤심, 탈장 부위 아려움
아래 눈꺼풀이 불룩함: 아래 눈꺼풀 부음, 아래 눈꺼풀 부풀어오름, 눈밑 붓기, 눈밑 불룩함, 아래 눈꺼풀 붓기
중이염소견: 귀 염증, 중이염 증상, 귀 염증 증상, 중이염 진단, 귀 안쪽 염증
단백뇨: 소변에 단백질, 단백질 소변, 소변 내 단백질, 단백질이 섞인 소변, 단백뇨 증상
파행: 절뚝거림, 비정상적 걸음걸이, 다리 절음, 걷기 어려움, 파행 증상
시야장애: 시야 흐림, 시야 문제, 시력 장애, 시야 손실, 시각 장애
척추 측만: 척추 휘어짐, 척추 만곡, 척추 기형, 척추 곡선, 척추 옆으로 휘어짐
배뇨곤란: 소변 보기 어려움, 배뇨 문제, 소변 곤란, 소변 장애, 배뇨 장애
배변습관의 변화: 변비, 설사, 배변 패턴 변화, 배변 문제, 장운동 변화
생식기 궤양: 생식기 상처, 생식기 염증, 생식기 헐음, 성기 궤양, 성기 염증
성대 이상: 목소리 문제, 성대 문제, 목소리 변화, 성대 염증, 성대 손상
궤양: 상처, 헐음, 염증, 궤양증, 상처 부위
소변이 샘: 소변 누출, 소변 새기, 요실금, 소변 새는 증상, 요누출
눈운동신경마비: 눈 근육 마비, 눈 움직임 장애, 눈운동 문제, 안구 운동 마비, 눈 신경 마비
양반다리로 앉기힘듬: 양반다리 어려움, 다리 꼬기 힘듦, 다리 접기 어려움, 양반다리 불편, 다리 꼬기 문제
잦은 딸꾹질: 빈번한 딸꾹질, 자주 나는 딸꾹질, 반복적인 딸꾹질, 계속되는 딸꾹질, 딸꾹질 빈번
저산소증: 산소 부족, 저산소 상태, 산소 결핍, 산소 결핍증, 저산소 현상
여드름: 피부 트러블, 뾰루지, 얼굴 여드름, 피부 발진, 얼굴 트러블
신생아의 기형: 아기 기형, 신생아 결함, 신생아 이상, 아기 선천적 문제, 신생아의 선천성 기형
요도 불쾌감: 요도 불편함, 요도 문제, 요도 불편감, 요도 통증, 요도 이물감
고혈압: 혈압 상승, 높은 혈압, 혈압 문제, 고혈압 증상, 혈압 증가
조급증: 성급함, 초조함, 급한 성격, 조급한 마음, 조급한 상태
공복감: 배고픔, 허기, 공복 상태, 배고픈 느낌, 허기짐
말단비대: 손발 커짐, 말단 비대증, 손발 비대, 손발 비대증, 말단 부위 커짐
질은 없거나 짧은 맹관: 질 결손, 짧은 질, 질 부재, 질 짧음, 질 기형
무욕증: 욕구 상실, 무기력, 동기 부여 없음, 의욕 상실, 무관심
발기부전: 발기 문제, 발기 장애, 발기 안됨, 발기 어려움, 발기 불능
생리량 감소: 적은 생리량, 월경량 감소, 생리 줄어듦, 월경량 줄어듦, 생리 적음
피부염증: 피부 염증, 피부 트러블, 피부 발진, 피부 문제, 피부염
양수의 감소: 양수 줄어듦, 양수 부족, 양수 감소, 양수량 감소, 양수 적음
태반의 조기 박리: 태반 조기 분리, 태반 박리, 태반 문제, 태반 분리, 조기 태반 박리
안쪽 발이 튀어 나옴: 내반족, 안쪽 발 돌출, 발 내반증, 발 안쪽 문제, 내반족 증상
뼈의 변형: 뼈 기형, 뼈 문제, 뼈 모양 이상, 뼈 변형 증상, 뼈의 이상
안구건조: 눈 마름, 건조한 눈, 눈 건조증, 안구 건조증, 눈의 건조
습관성 유산: 반복 유산, 자주 유산, 재발성 유산, 계속되는 유산, 유산 반복
색맹: 색 인식 문제, 색상 구분 어려움, 색 구별 못함, 색맹증, 색 구분 장애
회음부의 파열: 회음부 손상, 회음부 찢어짐, 회음부 파열 증상, 회음부의 상처, 회음부 파열 상태
재채기: 재채기 증상, 재채기 발작, 자주 나는 재채기, 연속 재채기, 갑작스러운 재채기
고혈당: 높은 혈당, 혈당 상승, 혈당 문제, 혈당 증가, 당 수치 증가
월경과다: 생리량 많음, 많은 월경량, 과다 월경, 생리 많이 나옴, 월경 과다증
각질이 딱딱해짐: 딱딱한 각질, 두꺼운 각질, 각질 경화, 피부 딱딱해짐, 피부 각질 문제
치아 벌어짐: 치아 간격, 벌어진 치아, 치아 틈, 치아 사이, 치아 간격 벌어짐
분뇨: 대변, 변, 분뇨 증상, 배설물, 배변 문제
위염: 위 염증, 위의 염증, 위염 증상, 위 문제, 위장 염증
위장관 출혈: 위 출혈, 장 출혈, 위장관 내 출혈, 위장 출혈, 위장관의 출혈
자율신경장애: 자율신경 문제, 자율신경계 이상, 자율신경계 문제, 자율신경계 장애, 자율신경 이상
함몰가슴: 가슴 함몰, 가슴 들어감, 흉부 함몰, 가슴 뼈 들어감, 흉곽 함몰
복부비만: 뱃살, 복부 지방, 뱃살 증가, 복부 비대, 복부 비만증
피부 건조: 마른 피부, 피부 건조증, 건조한 피부, 피부 건조 문제, 피부 건조 상태
무논리증: 비논리적 사고, 논리 결여, 비논리적 생각, 무논리 상태, 논리 없는 사고
사마귀 위 털이 많음: 사마귀 털, 털이 많은 사마귀, 사마귀의 털, 사마귀 위의 털, 사마귀와 털
미란: 피부 벗겨짐, 피부 손상, 피부 미란, 피부 까짐, 미란 증상
애착 상대와 분리 거부: 분리 불안, 분리 거부증, 애착 대상 분리 거부, 분리 불안증, 애착 대상과의 분리 문제
위험한 행동 반복: 반복적 위험 행동, 위험 행위, 위험한 행동, 위험 행동 증상, 위험 행동 반복 문제
물집성 표피 박리: 물집 박리, 표피 벗겨짐, 물집성 피부, 물집 생김, 피부 물집
귀 상부가 두피에 매몰됨: 귀 상부 매몰, 귀 윗부분 매몰, 귀 윗부분 함몰, 매몰된 귀, 함몰된 귀
피부궤양: 피부 상처, 피부 궤양, 피부 염증, 피부 헐음, 피부 손상
우울: 우울감, 우울증, 기분 저하, 기분 침체, 우울 상태
심혈관계 증상: 심장 문제, 심혈관 문제, 심혈관 증상, 혈관 문제, 심혈관 질환
관절 불안정증: 불안정한 관절, 관절 문제, 관절 불안정 상태, 관절 불안정 증상, 관절 움직임 문제
신경과민: 과민성, 예민함, 신경 예민, 과민 반응, 신경 과민 상태
발끝으로 설 수 없음: 발끝 못 섬, 발끝 서기 어려움, 발끝 서기 문제, 발끝 서기 불가, 발끝 서기 장애
초록색 구토: 녹색 구토, 초록빛 토, 녹색 토사물, 녹색 구토물, 초록 토
백혈구 증가: 높은 백혈구 수치, 백혈구 수치 증가, 백혈구 과다, 백혈구 증가증, 백혈구 많음
만성 신부전: 신장 기능 저하, 만성 신장 문제, 신부전증, 만성 신장 질환, 신장 기능 상실
환부 통증: 상처 부위 통증, 상처 아픔, 환부의 아픔, 상처 부위 아픔, 환부 불편감
안면부 출혈: 얼굴 출혈, 얼굴 피, 얼굴 부위 출혈, 얼굴의 피, 안면 출혈
덩어리가 만져짐: 만져지는 덩어리, 만져지는 혹, 덩어리 감지, 덩어리 존재, 혹 만져짐
생식기 부종: 성기 부종, 생식기 붓기, 생식기 부음, 성기 붓기, 생식기 부종증
침 분비 증가: 침 많이 남, 침 분비 과다, 침이 많이 나옴, 침 분비 많음, 침 흐름
반사 이상: 반사 문제, 반사 장애, 반사 작용 문제, 반사 작용 이상, 반사 장애 증상
초조함: 긴장감, 불안감, 불안, 신경질, 초조 상태
접촉도착증: 접촉 문제, 비정상적 접촉, 접촉 장애, 접촉 집착, 접촉 도착
안면통: 얼굴 통증, 안면 아픔, 얼굴의 아픔, 얼굴 불편감, 안면부 통증
청각과민: 예민한 청각, 소리 예민함, 청각 과민 상태, 청각 민감증, 소리 민감함
뇌염증상: 뇌염 증상, 뇌 염증 증상, 뇌염 징후, 뇌 염증, 뇌염 문제
비정상적 성적 기호: 비정상적 성적 취향, 이상한 성적 취향, 비정상 성적 선호, 비정상 성적 성향, 성적 기호 문제
목의 통증: 목 아픔, 목의 불편감, 목 통증, 목이 쑤심, 목 불편함
인설: 비듬, 피부 비듬, 각질, 각질 비듬, 피부 인설
대화에 불쑥 끼어듬: 불쑥 끼어들기, 대화 방해, 대화 끼어듦, 말 끼어듦, 대화 중단
신생아의 정신 장애: 아기 정신 문제, 신생아 정신 문제, 아기 정신 장애, 신생아 정신 이상, 신생아 정신 건강 문제
낮은 학업 성취: 학업 성취 저하, 학업 성적 낮음, 학습 성취 저하, 낮은 학습 성취, 학업 성적 저조
구내염: 입안 염증, 구강 염증, 입 염증, 구내 염증, 입속 염증
팔의 길이가 달라짐: 팔 길이 차이, 다른 팔 길이, 팔 길이 불균형, 길이가 다른 팔, 팔의 불균형
근육긴장: 근육 경직, 근육 뭉침, 근육 긴장 상태, 근육 긴장도, 뭉친 근육
피해망상: 피해 의식, 피해 상상, 피해 망상증, 피해 정신, 피해망상 상태
볼이 처짐: 처진 볼, 볼의 처짐, 볼 살 처짐, 처진 뺨, 볼 처짐 상태
토혈: 피 토함, 피 섞인 토, 피가 섞인 구토, 피가 나오는 구토, 피를 토함
대변에 벌레 관찰됨: 변에 벌레, 대변 벌레, 변에서 벌레 발견, 대변 속 벌레, 변에 보이는 벌레
의심: 의혹, 의문, 불신, 의구심, 확신 없음
검은색 가래: 흑색 가래, 검은 가래, 어두운 가래, 진한 색 가래, 검은색 점액
피부가 두꺼워짐: 두꺼운 피부, 피부 두꺼움, 피부 경화, 피부 두꺼워짐 증상, 두꺼워진 피부
방광 팽만: 팽창된 방광, 방광 부풀어오름, 방광 팽창, 부풀어 오른 방광, 방광 팽만 증상
십이지장궤양: 위궤양, 소장 궤양, 소화기 궤양, 장의 궤양, 소화관 궤양
청력장애: 귀먹음, 소리 못 들음, 청각 문제, 청력 손실, 귀 안들림
후각장애: 냄새 못 맡음, 후각 손실, 후각 문제, 냄새 감각 문제, 후각 상실
잦은 상기도 감염: 빈번한 감기, 자주 걸리는 감염, 상기도 문제, 잦은 감염, 상기도 염증
고환에 낭이 만져짐: 고환 혹, 고환 결절, 고환 부기, 고환 덩어리, 고환에 혹
피부 각질: 각질층, 피부 거칠어짐, 건조한 피부, 피부 각질화, 피부 비듬
상지 마비: 팔 마비, 팔 움직임 불가, 상체 마비, 상지 불편, 팔의 무감각
작열감: 화끈거림, 타는 느낌, 뜨거운 감각, 불타는 느낌, 작열감 증상
보행이상: 걷기 어려움, 비정상적 걸음걸이, 보행 문제, 걷는 데 문제, 보행 장애
피부균열: 갈라진 피부, 피부 틈, 피부 균열, 피부 갈라짐, 건조로 인한 균열
혈전증: 혈전 형성, 혈전 발생, 혈액 응고, 혈관 막힘, 혈전 문제
사시: 눈 돌림, 사팔뜨기, 눈 비대칭, 눈 초점 불일치, 시선 비정상
항문주위 염증: 항문 염증, 항문 부기, 항문 주변 염증, 항문 부위 염증, 항문 주위 부종
손상부위 촉각 소실: 손상 부위 무감각, 손상된 부분 감각 소실, 상처 부위 무감각, 상처 부위 감각 소실, 손상된 부위 감각 문제
달걀 위에 앉아있는 느낌: 둥근 느낌, 둥글게 앉은 느낌, 안락함, 달걀 모양 앉기, 편안한 자세
호기의 증가: 숨내뿜기 증가, 호흡 증가, 날숨 증가, 호기량 증가, 호흡량 증가
저혈량 쇼크: 혈액 부족 쇼크, 저혈압 쇼크, 쇼크 상태, 혈액 감소 쇼크, 저혈량 상태
활력징후 이상: 비정상적인 활력징후, 활력 신호 문제, 활력 지표 이상, 생명 징후 이상, 비정상적인 생체 신호
관음증: 엿보기 성향, 몰래 보기, 성적 호기심, 관음 성향, 관음 행위
인지장애: 인식 문제, 인지 문제, 지각 장애, 인지 기능 저하, 인지력 감소
발한: 땀흘림, 땀 분비, 땀 많이 남, 과다 발한, 땀 증가
경부 강직: 목 경직, 목 뻣뻣함, 목 굳음, 목 움직임 불가, 목의 경직 상태
뿔 모양의 병변: 돌출 병변, 뿔 모양 혹, 뿔 형태 상처, 돌기 병변, 뿔 모양 상처
안구내 출혈: 눈 출혈, 안구 출혈, 눈 속 출혈, 안쪽 눈 출혈, 눈 혈관 출혈
높아진 자존심: 자존감 상승, 자신감 과잉, 자만심, 높은 자부심, 자존심 과잉
유방의 멍울: 유방 혹, 유방 결절, 유방 덩어리, 유방의 혹, 유방 부기
점 안에 다른 색 피부: 이색 점, 잡색 점, 다른 색의 점, 색 변형 점, 색 변화 점
소변을 볼 수 없음: 배뇨 불가, 소변 안 나옴, 배뇨 장애, 소변 막힘, 배뇨 문제
자살의 위험: 자살 가능성, 자살 충동, 자살 시도 위험, 자해 위험, 자살 생각
거품이 섞인 가래: 거품 가래, 거품 있는 가래, 거품 섞인 점액, 거품 기침, 거품 있는 점액
불안: 걱정, 초조, 불안감, 긴장, 불안 상태
동정맥루 잡음 약화: 동정맥루 소리 감소, 동정맥루 소리 약함, 동정맥루 잡음 저하, 혈관 잡음 약화, 동정맥루 소리 문제
얼굴에 털이 자람: 얼굴 털, 얼굴 털 성장, 얼굴에 난 털, 얼굴에 나는 털, 얼굴 털 문제
팔의 통증: 팔 아픔, 팔 불편감, 팔 통증, 팔의 쑤심, 팔의 아픔
이마의 주름: 이마 주름살, 이마의 주름, 주름진 이마, 주름 생긴 이마, 이마 주름 문제
잇몸 위축: 잇몸 퇴축, 잇몸 감소, 잇몸 후퇴, 잇몸 줄어듦, 잇몸 문제
탈장: 탈출증, 장기 탈출, 장기 돌출, 탈장 증상, 장기 문제
담도감염: 담관 염증, 담관 감염, 담도 염증, 담도 질환, 담관 문제
뇌출혈: 뇌 속 출혈, 두개 내 출혈, 뇌혈관 출혈, 뇌 내부 출혈, 뇌출혈 증상
강박증: 강박 장애, 집착 증상, 강박 행동, 강박 성향, 강박 문제
당뇨: 당뇨병, 고혈당증, 혈당 문제, 당뇨 증상, 당 수치 증가
근육의 뒤틀림: 근육 경련, 근육 이상, 근육 비틀림, 근육 문제, 근육 경련 증상
요정체: 소변 정체, 요 배출 문제, 소변 막힘, 요 정체 증상, 소변 배출 장애
코의 모공이 커짐: 커진 코 모공, 확장된 코 모공, 코 모공 문제, 큰 코 모공, 넓은 코 모공
눈 감을 때 번쩍거림: 눈 감을 때 빛, 눈 감을 때 반짝임, 눈 감으면 빛, 눈 감을 때 섬광, 눈 감을 때 빛남
흡수장애: 소화 흡수 문제, 흡수 기능 장애, 영양 흡수 문제, 소화 흡수 장애, 영양 섭취 문제
발작적인 울음: 갑작스런 울음, 울음 발작, 울음 증상, 계속되는 울음, 발작성 울음
안구진탕: 눈 떨림, 안구 떨림, 눈 진동, 안구 흔들림, 눈의 떨림
안면마비: 얼굴 마비, 얼굴 신경 마비, 안면 신경 마비, 얼굴 움직임 불가, 안면 근육 마비
오한: 추위 느낌, 몸의 한기, 한기 증상, 추운 느낌, 몸의 오한
종양부위 부종: 종양 부기, 종양 주변 부종, 종양 부위 부기, 종양 부위 붓기, 종양 부위 부풀어오름
손떨림: 손의 떨림, 손 진전, 손의 진동, 떨리는 손, 손의 떨림 증상
운동장애: 운동 문제, 운동 기능 장애, 움직임 문제, 운동 능력 저하, 운동 장애 증상
손가락의 변형: 변형된 손가락, 비정상 손가락, 구부러진 손가락, 손가락 모양 이상, 손가락 기형
치근단 부위 부종: 치근 부기, 치아 뿌리 부기, 치근 부종, 치아 뿌리 부종, 치아 뿌리 붓기
얼굴부종: 얼굴 부기, 얼굴 붓기, 얼굴의 부종, 얼굴 부풀어오름, 얼굴 붓기 증상
치아가 솟은 느낌: 치아 돌출, 치아 튀어나옴, 치아 융기, 솟은 치아, 치아 돌출 증상
심방 부정맥: 심장 부정맥, 불규칙한 심박, 심장 리듬 문제, 심장 박동 장애, 심방 리듬 문제
고름: 농, 화농, 염증 고름, 농액, 고름 분비
복시: 이중 시야, 겹쳐 보임, 두 개로 보임, 시야 중복, 복시 증상
안면 변형: 얼굴 기형, 얼굴 변화, 얼굴 왜곡, 비정상적 얼굴, 얼굴 형태 변형
치매: 기억 상실, 인지 장애, 치매 증상, 기억력 문제, 인지 기능 저하
비문증: 눈앞의 점, 눈의 부유물, 시야 내 점, 부유 물질, 비문 증상
반상출혈: 피부 출혈, 출혈 반점, 피부 반점, 작은 출혈, 출혈 점
딸기혀: 빨간 혀, 붉은 혀, 딸기 모양 혀, 딸기 색 혀, 혀 발진
약물남용: 약물 오용, 약물 의존, 약물 중독, 약물 남용 증상, 약물 문제
X자 다리: 내반슬, 휜 다리, X형 다리, 다리 변형, 다리 문제
사회적 고립: 외톨이, 혼자 있음, 사회적 단절, 고립된 상태, 사람들과 단절
임신 오조증: 심한 입덧, 임신 중 구토, 임신 중 메스꺼움, 임신 중 구역질, 임신 초기 증상
탯줄의 압박: 탯줄 눌림, 탯줄 얽힘, 탯줄 문제, 태아 탯줄 압박, 탯줄 꼬임
발가락 사이 갈라짐: 발가락 틈, 발가락 갈라짐, 발가락 사이 틈새, 발가락 벌어짐, 발가락 간격
하얀 반점: 피부의 백반, 흰 반점, 백색 반점, 피부 하얀 점, 백반증
장액성 분비물: 맑은 분비물, 물 같은 분비물, 장액 분비, 액체 분비물, 투명한 분비물
요통: 허리 통증, 등 아픔, 허리 아픔, 등 통증, 허리 불편함
피학증: 자해 성향, 자학 성향, 스스로 상처냄, 자해 욕구, 피학적 행동
폐기능저하: 폐 기능 약화, 폐 능력 감소, 호흡 곤란, 폐활량 저하, 폐 문제
위의 연동운동이 보임: 위 연동 운동, 위의 움직임, 위 운동 보임, 위가 움직임, 위 연동 작용
혈뇨: 소변에 피, 피 섞인 소변, 붉은 소변, 혈액 소변, 피가 나오는 소변
대비감 감소: 대비 약화, 대비감 소실, 대비감 저하, 눈 대비감 감소, 대비 인식 문제
다발성 관절염: 여러 관절염, 다발 관절염, 여러 관절 통증, 관절염 증상, 관절 염증
커지지 않는 자궁: 자궁 발달 문제, 작은 자궁, 자궁 크기 문제, 자궁 성장 부진, 자궁 성장 저하
보챔: 짜증, 투정, 칭얼거림, 불편함, 계속되는 보챔
잔뇨감: 소변 남음, 배뇨 후 잔뇨, 남은 소변, 소변 끝나지 않음, 잔뇨 증상
골반 통증: 골반 아픔, 골반 불편감, 골반 통증 증상, 골반 쑤심, 골반의 아픔
비정상적 질 분비물: 이상한 질 분비물, 비정상 질액, 질 분비 문제, 질액 변화, 질 분비물 이상
음경이 휘어짐: 음경 굽음, 음경 기형, 음경 모양 문제, 휜 음경, 굽은 성기
어깨의 통증: 어깨 아픔, 어깨 불편감, 어깨 통증 증상, 어깨 쑤심, 어깨의 아픔
회색변: 회색 대변, 회색 똥, 색이 변한 대변, 회색 변, 회색 변색
하지부종: 다리 부기, 다리 붓기, 다리 부종, 하지의 부기, 붓는 다리
위장관의 허혈: 장기 허혈, 위장 허혈, 위장관 혈류 부족, 소화기관 허혈, 장기의 혈액 부족
근육마비: 근육 움직임 불가, 근육 기능 상실, 근육 마비 상태, 근육 통제 불가, 근육 마비 증상
비현실감: 현실감 상실, 비현실 느낌, 비현실적 감각, 비현실적 상태, 현실감 저하
근육경련: 근육 떨림, 근육 경직, 근육 발작, 근육 수축, 근육의 경련
유방의 퇴행: 유방 위축, 유방 크기 감소, 유방 기능 저하, 유방의 변화, 유방 쇠퇴
구강궤양: 입안 궤양, 구강 염증, 입 안 상처, 구강의 궤양, 입 안 염증
발의 통증: 발 아픔, 발 불편감, 발 통증, 발 쑤심, 발의 아픔
요로감염: 요도 염증, 방광염, 요로 질환, 소변 감염, 요도 문제
관절통: 관절 아픔, 관절 불편감, 관절 통증, 관절의 아픔, 관절 쑤심
거인증: 신체 거대증, 몸 거대화, 거대화 증상, 거대한 신체, 거대화 현상
편두통: 심한 두통, 한쪽 두통, 편측 두통, 두통 발작, 편측성 두통
직무 태만: 직무 불이행, 직무 소홀, 업무 태만, 업무 소홀, 직무 게을리 함
산혈증: 산증, 혈액 산성화, 혈액의 산성, 산성화된 혈액, 산성 혈액
검은 점: 피부 검은 점, 검정 반점, 피부의 검은 점, 어두운 반점, 검은색 반점
심잡음: 심장 소음, 심장 잡음, 비정상적 심장 소리, 심장 소리 문제, 심장 소리 이상
빛이나 소리 공포증: 광공포증, 소리 공포증, 빛 공포증, 소음 공포증, 빛과 소리에 대한 두려움
미세반점의 군집: 작은 반점들, 군집된 반점, 피부 미세반점, 미세반점 모임, 작고 많은 반점
발적: 붉은 피부, 피부 발진, 붉은 반점, 피부 염증, 피부 붉어짐
뼈 전이: 뼈로 퍼짐, 뼈로 전이된 암, 뼈로의 전이, 뼈로 확산, 뼈 전이 증상
수면 중 보행: 잠결에 걷기, 몽유병, 수면 보행, 자면서 걷기, 잠 중 보행
시력 감소: 시력 저하, 눈 시력 약화, 시력 손실, 시력 문제, 시각 저하
말초 신경장애: 말초 신경 문제, 말초 신경 손상, 말초 신경 이상, 신경 장애, 말초 신경 기능 저하
비웃는 듯한 표정: 냉소적 표정, 비웃음, 조롱하는 얼굴, 비웃는 얼굴, 조롱하는 표정
혼돈: 혼란, 정신 혼란, 혼동 상태, 정신적 혼란, 머리 속 혼란
말초 통증: 손발 통증, 말단 통증, 말초부 통증, 팔다리 통증, 말초의 아픔
농신증: 신장 염증, 신장 감염, 신장 질환, 신장 농양, 신장에 염증
창백: 얼굴 창백, 피부 창백, 혈색 없음, 창백한 상태, 얼굴 하얘짐
척추 후만: 척추 굽음, 척추 만곡, 척추 곡선, 척추 기형, 뒤로 휜 척추
흉곽 팽윤: 가슴 부기, 흉곽 부풀어오름, 가슴 확장, 흉부 팽창, 흉곽의 부기
모발이 가늘어짐: 머리카락 얇아짐, 가는 머리카락, 얇아진 모발, 모발 가늘어짐 증상, 머리카락의 가늘어짐
부유물이 보임: 떠다니는 물질, 부유물 관찰, 부유물 존재, 부유물 증상, 떠다니는 이물질
얼굴의 나비모양 홍반: 나비모양 발진, 얼굴 발진, 나비모양 붉은 반점, 얼굴의 나비 발진, 나비 모양의 홍반
자세이상: 자세 문제, 자세 불균형, 비정상적 자세, 자세 불량, 자세의 이상
비출혈: 코피, 코에서 피남, 코피 증상, 비강 출혈, 코 출혈
말초의 허혈: 손발 혈류 부족, 말초 혈액 문제, 말초 혈류 저하, 손발 혈액 순환 문제, 말초 허혈 증상
악취가 나는 설사: 냄새나는 설사, 고약한 냄새 설사, 악취 설사, 냄새 심한 설사, 악취 동반 설사
목 뒷부분의 지방축적: 목뒤 지방, 목뒤 살, 목의 지방 축적, 뒷목 지방, 목 뒷부분 살
파열음: 터지는 소리, 찢어지는 소리, 파열 소리, 갈라지는 소리, 파열음 증상
심부정맥혈전증: 깊은 정맥 혈전, 심부정맥 혈전증, 깊은 혈관 혈전, 심부 혈전, 혈관에 생긴 혈전
구강건조: 입마름, 입안 건조, 구강의 건조, 마른 입, 건조한 구강
대사성 산증: 대사성 산성화, 대사 문제, 대사 장애, 대사성 산성, 대사성 문제
체중증가: 살찌기, 체중 늘어남, 몸무게 증가, 체중 변화, 살이 찜
손가락 운동장애: 손가락 움직임 문제, 손가락 기능 저하, 손가락 운동 문제, 손가락 운동 장애 증상, 손가락 움직임 불가
근시: 가까운 것만 보임, 근거리 시력, 근시안, 원거리 시력 저하, 근시 증상
목의 이물감: 목에 걸린 느낌, 목에 뭔가 있는 느낌, 목 이물질, 목에 걸린 것 같은 느낌, 목의 불편감
무릎 부위 부종: 무릎 부기, 무릎 붓기, 부은 무릎, 무릎의 부종, 무릎 부풀어오름
음낭 부종: 고환 부기, 음낭 붓기, 부은 음낭, 음낭의 부종, 고환 부종
태아 뼈: 아기 뼈, 태아 골격, 태아의 뼈, 태아 골격 문제, 아기 골격
근긴장의 이상: 근육 긴장 문제, 근육 긴장 이상, 근육의 긴장도 변화, 근육의 긴장 문제, 비정상적 근긴장
반복적인 동작: 반복 행동, 지속적인 동작, 같은 동작 반복, 반복적 움직임, 동작의 반복
고환 불쾌감: 고환의 불편감, 고환 통증, 고환 불편, 고환의 문제, 고환 이상
환청: 헛소리 들림, 들리지 않는 소리, 소리 환상, 환청 증상, 환각 소리
코플릭 반점: 코플릭 점, 입 안 반점, 코플릭 증상, 입안의 반점, 코플릭 징후
멍: 타박상, 피멍, 피부 멍, 멍 자국, 멍든 자리
생식기 출혈: 성기 출혈, 생식기에서 피남, 성기에서 피, 생식기 피출, 생식기 혈액
성생활이 힘듦: 성생활 문제, 성생활 불편, 성관계 문제, 성생활 어려움, 성생활의 불편
유방의 과다 성장: 유방 비대, 유방 성장, 유방 커짐, 큰 유방, 유방의 비대
늑막삼출: 흉막 삼출, 늑막에 물참, 흉막에 물참, 흉막 삼출증, 늑막의 삼출
심실세동: 심장세동, 심실 떨림, 심실의 세동, 심실 문제, 심장의 세동
방향감각 상실: 방향 잃음, 방향 감각 문제, 방향 인식 불가, 방향 감각 장애, 길 찾기 어려움
유루증: 눈물 흐름, 눈물 과다, 눈물 많이 남, 눈물 과다 증상, 눈물샘 문제
요독증: 요독 축적, 혈액 내 요독, 신장 요독증, 요독 증가, 신장의 요독
눈부심: 빛에 민감함, 눈이 부심, 밝은 빛 불편, 눈부신 상태, 강한 빛 민감
지방변: 기름진 변, 지방이 섞인 변, 기름 변, 지방 함유 변, 지방 배출
영양 불량: 영양 부족, 영양 결핍, 영양 불균형, 영양 상태 불량, 영양 문제
전신 통증: 온몸의 통증, 몸 전체 통증, 전신 아픔, 몸의 통증, 전신의 아픔
놀람반사의 약화: 놀람 반응 감소, 놀람 반사 저하, 놀람 반응 약해짐, 놀람 반사 약화, 놀람 반응 둔해짐
인내심이 부족함: 참을성 부족, 인내심 결여, 참을성 없음, 인내심 약함, 인내 부족
눈의 피로: 눈 피로감, 피곤한 눈, 눈의 피곤함, 눈의 피로 증상, 눈이 피곤함
유방 크기의 감소: 유방 축소, 유방 크기 줄어듦, 유방 작아짐, 유방 크기 감소 증상, 유방 크기 문제
분출성 구토: 폭발적 구토, 급작스러운 구토, 분출 구토, 강한 구토, 분출성 토
와해된 행동: 비정상적 행동, 혼란스러운 행동, 무질서한 행동, 행동의 와해, 행동 붕괴
체모감소: 체모 줄어듦, 털 감소, 몸털 줄어듦, 체모 적어짐, 몸털 감소
목소리 변화: 목소리 변함, 음성 변화, 목소리 변화 증상, 목소리 이상, 음성 문제
딱지: 상처 딱지, 흉터 딱지, 굳은 딱지, 딱지 형성, 딱지 증상
금단증상: 금단 현상, 금단 증세, 금단 문제, 금단 징후, 금단의 고통
사춘기 지연: 늦어진 사춘기, 사춘기 지체, 사춘기 발달 지연, 사춘기 늦어짐, 늦은 사춘기
귀두가 울혈됨: 귀두 붓기, 귀두 혈액 저류, 귀두 울혈 증상, 귀두 부기, 귀두 혈액 문제
야만적 행위: 폭력적 행동, 잔인한 행동, 야만적 행동, 과격한 행동, 난폭한 행동
양무릎사이 벌어짐: 벌어진 무릎, 양쪽 무릎 벌어짐, 무릎 간격, 무릎 틈, 양 무릎 사이 간격
만성 부비동염: 만성 비염, 만성 부비동 염증, 만성 코 염증, 만성 부비동 문제, 만성 비강 염증
가래: 점액, 기침 가래, 가래 끓음, 끈적한 가래, 가래 증상
간비대: 커진 간, 간 비대증, 간 크기 증가, 간 확대, 간 비대 상태
야간뇨: 밤에 자주 소변, 야간 배뇨, 야뇨증, 밤중 소변, 밤에 소변 보기
위궤양: 위장 궤양, 위 상처, 위 염증, 위 점막 손상, 위의 궤양
관절의 경직: 뻣뻣한 관절, 경직된 관절, 관절 경직 증상, 굳은 관절, 움직이기 힘든 관절
태선화: 피부의 경화, 피부 굳음, 피부가 딱딱해짐, 굳은 피부, 피부 태선화
병원 쇼핑: 의사 바꾸기, 여러 병원 방문, 병원 전전, 의사 바꾸기 증상, 병원 돌아다님
지연뇨: 지연된 배뇨, 배뇨 지연, 소변 늦어짐, 배뇨 문제, 지연된 소변
피부홍조: 얼굴 붉어짐, 피부 붉음, 붉어진 피부, 얼굴 홍조, 피부 홍조 증상
망상: 환각, 환상, 망상 증상, 잘못된 생각, 망상 장애
더위를 못 견딤: 더위 참기 어려움, 더위 불편, 더위 민감, 더위 견디기 어려움, 더위 문제
뼈의 통증: 뼈 아픔, 뼈의 아픔, 뼈 통증, 뼈 불편감, 뼈의 쑤심
머리모양 변형: 변형된 머리, 머리 기형, 머리 형태 이상, 머리 모양 변화, 머리 모양 문제
눈이 무거운 느낌: 눈의 피로감, 눈의 무거움, 눈 피곤함, 눈의 무겁게 느껴짐, 피로한 눈
온몸이 떨림: 몸의 떨림, 전신 떨림, 몸 떨림 증상, 몸이 떨려요, 몸의 떨림 현상
발바닥 피부 두꺼워짐: 두꺼워진 발바닥, 발바닥 각질, 발바닥 굳음, 발바닥 피부 경화, 발바닥 굳은살
물집: 수포, 물집 생김, 피부 물집, 물집 증상, 물집 형성
복부팽만감: 부은 배, 팽창된 복부, 배가 불러옴, 복부 팽만, 배부름 증상
닭살: 소름, 닭살 돋음, 소름 돋는 현상, 피부 소름, 닭살 증상
사경: 목 뒤틀림, 목 기울어짐, 목 경련, 목 근육 문제, 목 비정상 상태
회음부 불쾌감: 회음부 불편감, 회음부 아픔, 회음부 불쾌함, 회음부 통증, 회음부의 불편
질 밖으로 빠지는 느낌: 질 탈출, 질 밖 느낌, 질 내밀림, 질의 불편감, 질이 빠지는 느낌
고탄산증: 이산화탄소 축적, 혈중 이산화탄소 증가, 고탄산혈증, 이산화탄소 과다, 고탄산 상태
편마비: 한쪽 마비, 편측 마비, 반쪽 마비, 편측 마비 증상, 반신 마비
돌연사: 갑작스런 죽음, 급사, 예기치 못한 사망, 돌연 사망, 급작스런 사망
양막 유착: 태막 유착, 양막 문제, 태막 문제, 양막 부착, 태막 부착
복부 압박 증상: 배 압박, 복부 눌림, 복부 압박감, 배의 압박, 복부 압박 문제
시신경염: 눈 신경 염증, 시신경 문제, 시신경 염증 증상, 눈 신경 문제, 시신경 염증 상태
상동적 행동: 반복 행동, 틀에 박힌 행동, 습관적 행동, 동일한 행동 반복, 상동적 행위
포만감: 배부름, 포만 상태, 배불러요, 가득 참, 배 부른 느낌
미각이상: 맛 감각 문제, 맛 못 느낌, 미각 상실, 맛 인식 문제, 미각 장애
결절: 혹, 덩어리, 결절 증상, 피부 혹, 작은 혹
건망증: 기억력 저하, 기억 상실, 잘 잊음, 기억력 문제, 기억 장애
정맥혈전: 정맥의 혈전, 혈관 내 혈전, 정맥 응고, 혈전 형성, 정맥 막힘
정신 혼미: 혼란 상태, 정신적 혼미, 혼미 증상, 정신 흐림, 혼미 상태
O자 다리: 휜 다리, O형 다리, 다리 변형, 다리 기형, 다리 문제
성욕감퇴: 성욕 저하, 성적 욕구 감소, 성적 욕망 저하, 성적 욕구 문제, 성적 욕구 상실
옆구리 통증: 옆구리 아픔, 옆구리 통증 증상, 옆구리 불편감, 옆구리의 아픔, 옆구리 쑤심
정신 지체: 지적 장애, 지능 저하, 정신적 발달 문제, 정신 발달 지체, 지적 지연
탈장 돌출: 장기 탈출, 탈장 현상, 탈장 문제, 탈장 증상, 돌출된 장기
광대뼈 위치 이상: 광대뼈 문제, 광대뼈 변형, 비정상적 광대뼈, 광대뼈 위치 변화, 광대뼈 기형
언어장애: 말하기 문제, 언어 문제, 언어 소통 장애, 언어 능력 저하, 언어 표현 장애
낮은 지능: 지능 저하, 지적 수준 낮음, 낮은 IQ, 지적 능력 저하, 지적 발달 저하
울퉁불퉁한 상처: 고르지 않은 상처, 울퉁불퉁한 흉터, 울퉁불퉁한 자국, 울퉁불퉁한 상처 자국, 고르지 않은 흉터
사망: 죽음, 사망 증상, 목숨 잃음, 생명 상실, 목숨 끊김
부정맥: 불규칙한 심장 박동, 심장 박동 이상, 심장 리듬 문제, 부정맥 증상, 심박수 이상
발가락의 변형: 발가락 기형, 휜 발가락, 발가락 변형 증상, 발가락 문제, 발가락의 이상
식욕증가: 먹고 싶은 욕구 증가, 식욕 많아짐, 식욕 상승, 많이 먹고 싶음, 식욕 왕성
입술 갈라짐: 트는 입술, 갈라진 입술, 입술 균열, 입술 트기, 건조한 입술
헛배: 부른 배, 헛배부름, 부풀어 오른 배, 더부룩한 배, 팽창된 배
긴장: 불안, 초조함, 긴장 상태, 긴장감, 신경 쓰임
죽음에 대한 공포: 죽음의 두려움, 사망 공포, 죽음에 대한 두려움, 사망 두려움, 죽음의 공포감
신생아-백색의 결절: 아기 피부 결절, 하얀 결절, 신생아의 결절, 신생아 피부의 하얀 결절, 신생아의 피부 결절
다뇨: 소변 많이 봄, 잦은 소변, 다뇨 증상, 자주 소변 보기, 소변의 빈번함
글자가 휘어져보임: 글자 왜곡, 글자가 일그러짐, 글자 왜곡 보임, 글자가 휘어서 보임, 글자 왜곡 증상
두드러기: 피부 발진, 두드러기 증상, 두드러기 반점, 피부의 두드러기, 피부 반점
음핵비대: 큰 음핵, 비대한 음핵, 음핵 크기 증가, 커진 음핵, 음핵의 비대
정서적 둔마: 감정 무딤, 정서적 저하, 감정 둔화, 정서적 둔화, 감정 반응 저하
복수: 복강 내 물참, 배에 물참, 복부 부종, 복부 내 물, 복부의 물참
앞이 뿌옇게 보임: 흐린 시야, 뿌연 시야, 앞이 잘 안 보임, 앞이 흐려짐, 흐릿한 시야
지속적인 애성: 계속되는 애성, 애성 유지, 끊이지 않는 애성, 지속되는 울음소리, 애성 소리
얼굴형태의 이상: 얼굴 기형, 비정상적 얼굴, 얼굴의 이상, 얼굴 형태 문제, 얼굴 모양 변화
유방 통증: 가슴 아픔, 유방의 아픔, 가슴 통증, 유방 불편감, 유방의 통증
경정맥 확장: 목정맥 팽창, 경정맥 부기, 목정맥 확장, 목 혈관 팽창, 경정맥의 확장
빈맥: 빠른 심장 박동, 심박수 증가, 심장 박동 빠름, 빠른 심박수, 심박 급증
음모가 적거나 없음: 음모 감소, 음모 없음, 적은 음모, 음모 부족, 음모의 감소
심실 부정맥: 심장 부정맥, 심실의 불규칙 박동, 심실 리듬 문제, 심실 박동 이상, 심실의 부정맥
뇌부종: 뇌 부기, 뇌 부종 증상, 뇌 부종 문제, 부어오른 뇌, 뇌의 부기
겨드랑이 멍울: 겨드랑이 혹, 겨드랑이 결절, 겨드랑이 부기, 겨드랑이 덩어리, 겨드랑이 멍울 증상
다지증: 손가락이 많음, 발가락이 많음, 다지증 증상, 손가락/발가락 추가, 손가락/발가락이 많음
연속동작의 느림: 느린 동작, 동작 지연, 연속 동작의 지연, 동작 속도 저하, 느려진 동작
눈의 충혈: 빨개진 눈, 눈 피로, 눈의 염증, 충혈된 눈, 피로한 눈
학습장애: 학습 문제, 학습 곤란, 학습 지연, 학습의 어려움, 학습 기능 저하
흑색변: 검은 대변, 까만 변, 어두운 색 변, 검정색 변, 검게 변한 변
발 굴곡 운동의 제한: 발 움직임 제한, 발 굴곡 어려움, 발의 굴곡 제한, 발 굴곡 장애, 발의 움직임 문제
박동성 통증: 맥박 통증, 뛰는 통증, 박동 통증, 맥동 통증, 박동의 아픔
지남력 장애: 방향 감각 상실, 시간/장소 감각 문제, 지남력 저하, 방향 감각 문제, 지남력 손실
실행증: 행동 실행 어려움, 행동 장애, 실행 장애, 행동 실행 문제, 실행 불가
운동 시 호흡곤란: 운동 중 숨참, 운동할 때 호흡 곤란, 운동 시 숨쉬기 어려움, 운동 시 숨가쁨, 운동 시 호흡 문제
근육강직: 근육 경직, 뻣뻣한 근육, 근육의 경직, 근육 굳음, 굳어진 근육
이중음성: 두 겹의 소리, 이중 소리, 두 개의 음성, 이중 목소리, 겹친 소리
기민상태: 예민한 상태, 민감한 상태, 날카로운 상태, 빠른 반응, 예민한 반응
환각: 헛것 보임, 환상, 환시, 헛것 느낌, 헛것 감각
성대마비: 목소리 마비, 성대 기능 상실, 성대 움직임 불가, 성대 문제, 성대의 마비
엄지 발가락의 돌출: 튀어나온 엄지발가락, 돌출된 엄지발가락, 엄지발가락의 돌출, 돌출된 엄지, 엄지의 돌출
사물이 두개로 보임: 이중 시야, 두 개로 보임, 겹쳐 보이는 시야, 두 개로 보이는 것, 이중으로 보임
손 발톱이 갈라짐: 갈라진 손발톱, 깨진 손발톱, 손발톱 균열, 손발톱의 갈라짐, 부서진 손발톱
임신 주수보다 작은 배: 작은 임신 배, 작은 임신 복부, 임신 주수보다 작은 복부, 작은 임신 배 모양, 주수보다 작은 배
갑상선 비대: 커진 갑상선, 갑상선 부기, 비대한 갑상선, 갑상선 부종, 갑상선의 비대
혈변: 피 섞인 변, 붉은 대변, 혈액 변, 피가 나온 변, 혈액이 섞인 변
홍채가 흔들거림: 흔들리는 홍채, 떨리는 홍채, 불안정한 홍채, 움직이는 홍채, 떨리는 홍채 증상
와해된 언어: 비정상 언어, 무질서한 언어, 와해된 말, 혼란스러운 언어, 와해된 표현
기억장애: 기억 상실, 기억력 저하, 기억 문제, 기억력 장애, 기억 상실 증상
항문출혈: 항문에서 피, 항문 피출, 항문 출혈 증상, 항문의 피, 항문 혈액
태아: 아기, 배 속 아기, 태중 아기, 태아 상태, 태아의 성장
눈꼽: 눈의 찌꺼기, 눈곱, 눈의 분비물, 눈의 찌꺼기, 눈의 더러움
경부 운동 제한: 목 운동 제한, 목 움직임 불가, 경부 움직임 제한, 목의 움직임 문제, 경부 경직
다리 통증: 다리 아픔, 다리 불편감, 다리의 아픔, 다리 쑤심, 다리 통증 증상
오심: 메스꺼움, 구역질, 속 울렁거림, 구토감, 속 메스꺼움
호흡기감염: 호흡기 질환, 호흡기 감염증, 호흡기 문제, 호흡기 감염 상태, 호흡기 염증
의식 저하: 의식 흐림, 정신 혼미, 의식 감소, 의식 상실, 정신 저하
후궁반장: 경련성 몸 반장, 척추 후궁반장, 몸 경련, 후궁반장 증상, 척추 경련
차갑고 축축한 피부: 찬 피부, 차고 젖은 피부, 차갑고 촉촉한 피부, 차갑고 습한 피부, 차갑고 축축한 상태
갱년기 증상: 갱년기 변화, 갱년기 문제, 갱년기 장애, 갱년기 증후, 갱년기의 증상
각막 위로 결막 침범: 결막의 각막 침범, 결막이 각막으로, 각막 결막 문제, 결막의 각막 덮음, 각막 결막 침범
검붉은 색 피부: 검붉은 피부색, 어두운 붉은 피부, 검은 붉은 피부, 붉은색 피부, 어두운 붉은색 피부
복부 통증: 배 아픔, 복부 불편감, 복부 통증 증상, 배의 아픔, 복부의 통증
이명: 귀 울림, 귀에서 소리남, 귀의 소리, 귀가 울림, 귀소리 증상
동공산대: 커진 동공, 확장된 동공, 동공의 확장, 동공이 커짐, 넓어진 동공
수면 무호흡: 자는 중 숨 멈춤, 수면 중 호흡 정지, 자는 동안 호흡 문제, 수면 중 무호흡, 자면서 숨 안 쉼
정상적인 성생활 불가능: 성생활 문제, 성생활 어려움, 성생활 불가, 정상 성생활 못함, 성관계 문제
귀의 통증: 귀 아픔, 귀 불편감, 귀 통증 증상, 귀의 아픔, 귀 쑤심
림프 부종: 림프 붓기, 림프 부기, 림프 부종 증상, 림프의 부기, 림프 시스템 부기
손가락 힘이 약해짐:손가락 힘 부족,손가락이 약함,손가락 힘 빠짐,손가락 힘 없음,손가락이 힘이 없음
안면홍조:얼굴 붉어짐,얼굴 빨개짐,얼굴 홍조,얼굴이 붉어짐,얼굴이 빨개짐
사정이 일찍 됨:조루,빠른 사정,조기 사정,빨리 사정,사정이 빠름
의식 불명:의식 없음,정신 잃음,깨어나지 못함,의식 불투명,의식 소실
방사통:퍼지는 통증,연관 통증,멀리 뻗는 통증,확산되는 통증,멀리 퍼지는 통증
코 옆과 입꼬리 주름:팔자 주름,코 옆 주름,입가 주름,팔자 주름살,코 주변 주름
안검내반:눈꺼풀 말림,눈꺼풀 안쪽 말림,속눈썹 안쪽 말림,눈꺼풀 안쪽으로 말림,속눈썹 눈 쪽으로 말림
희발월경:드문 월경,생리 간격 길어짐,가끔 오는 생리,생리 주기 길어짐,드문드문 오는 생리
사지 마비:팔다리 마비,팔다리 마비,사지가 마비됨,팔다리 힘 없음,사지 움직이지 않음
수면 후에도 피로함:자는 데도 피곤함,잘 자도 피곤함,잠을 자도 피로함,자는 데도 피로함,수면 후 피로
권리를 강하게 주장:강력한 권리 주장,권리 요구 강함,권리 강하게 요구,강한 권리 주장,권리를 세게 주장
촘촘하게 난 털:빽빽한 털,촘촘한 털,많이 난 털,털이 촘촘함,숱 많은 털
성조숙증:이른 사춘기,조기 성숙,빨리 오는 사춘기,사춘기 일찍 옴,빠른 성숙
변실금:대변 실금,변 못 참음,대변 새어 나옴,변이 샘,대변 조절 불가
상처보다 넓게 자람:과잉 성장 상처,상처가 커짐,상처 과잉 성장,상처가 넓어짐,상처 확장
태아 저체중:저체중 태아,태아 몸무게 적음,작은 아기,태아가 작음,체중 적은 태아
소양감:가려움,가려운 느낌,피부 가려움,간지러움,가려운 증상
암점:시야의 암점,검은 점,시야에 보이는 점,눈 앞의 점,시야의 어두운 점
사물이 찌그러져 보임:왜곡된 시야,찌그러진 시야,물체 왜곡,사물이 비뚤어짐,물체가 찌그러짐
수면 시작이 어려움:잠들기 어려움,잠드는 데 시간 걸림,잠 못 듦,쉽게 잠들지 않음,수면 시작 어려움
신장 발육부전:신장 발달 부진,신장 성장 부족,신장 발육 저하,신장 미성숙,신장 발육 장애
저림:찌릿함,저린 느낌,찌릿찌릿함,저린 증상,손발 저림
발이 안쪽을 향해 걸음:발이 안으로 굽음,안쪽으로 걷는 발,발 안쪽으로 걸음,안쪽으로 휘는 발,발이 안쪽으로 향함
질에서 소변이 나옴:질 소변 누출,질 소변 샘,질에서 소변 흐름,질 소변 분비,질로 소변 나옴
좁은 공간에서의 불안감:폐소 공포증,좁은 곳 공포,밀실 공포,좁은 곳 불안,좁은 공간 두려움
눈의 통증:안구 통증,눈 아픔,눈이 쑤심,안구 아픔,눈의 아픔
야맹:야간 시력 저하,밤눈 어두움,야간 시야 불편,밤에 잘 안 보임,야간 시력 감퇴
눈물흘림:눈물 남,눈물이 흐름,눈물이 많음,눈물 분비,눈물 계속 남
갈증:목마름,목이 마름,갈함,물 마시고 싶음,갈한 느낌
귀에서 냄새가 남:귀 냄새,귀에서 악취,귀에서 나는 냄새,귀에서 냄새 풍김,귀 냄새 발생
다리가 잘 안 벌어짐:다리 벌리기 어려움,다리 안 벌어짐,다리 벌림 장애,다리 벌리기 불편,다리 벌리기 힘듦
외부 생식기가 모호함:모호한 생식기,애매한 생식기,불명확한 생식기,분명하지 않은 생식기,생식기 모호함
기침:기침소리,목에서 나는 기침,기침 증상,가래 기침,기침 소리 남
간부전:간 기능 상실,간 기능 부전,간 기능 저하,간 기능 장애,간 실패
나쁜 품행:불량한 행동,나쁜 행동,품행 문제,행실 불량,나쁜 행실
개 폐구 장애:입 열림 장애,입 닫기 어려움,입이 안 다물어짐,입 다물기 장애,입이 잘 안 닫힘
안면부 열상:얼굴 찢김,얼굴 상처,얼굴 열상,얼굴에 난 상처,얼굴 찢긴 상처
수면 중 이상한 행동:잠버릇,자면서 이상한 행동,수면 중 이상 행동,잠 중 이상한 행동,자면서 이상함
비정상적 질출혈:이상 질출혈,비정상적 생리,이상한 질출혈,생리 이상,질에서 이상 출혈
걸핏하면 눈물지음:쉽게 우는,자주 우는,눈물 잘 남,자주 눈물 흘림,눈물 많은
편도선 비대:편도 비대,편도 부음,편도선 부음,편도선 커짐,편도 부종
어깨 잡음:어깨에서 소리 남,어깨 소음,어깨에서 나는 소리,어깨 소리,어깨서 소리
성격의변화:성격 변함,성격 달라짐,성격 변동,성격 변화,성격 바뀜
간성뇌증:간성 뇌질환,간 뇌증,간 관련 뇌질환,간 질환 뇌증,간성 뇌병증
습진:피부염,피부 습진,가려운 피부병,피부 발진,피부 트러블
후각 감소:냄새 못 맡음,후각 둔함,후각 저하,냄새 인지 감소,후각 약해짐
근골격계 이상:뼈 근육 이상,근골격 문제,근육 뼈 문제,뼈 근육 문제,근골격 이상
갑상선이 단단해짐:딱딱한 갑상선,갑상선 경화,갑상선 단단함,갑상선 굳음,갑상선 딱딱해짐
운동 실어증:운동성 실어증,말 못하는 증상,말하기 어려움,언어장애,말 잘 안 나옴
손발가락이 6개 이상:여섯 손가락,여섯 발가락,손가락 여섯 개,발가락 여섯 개,다지증
피부경화:피부 굳음,딱딱한 피부,피부가 딱딱해짐,피부가 굳어짐,피부 단단해짐
황달:눈 노래짐,피부 노래짐,간질환 노란증상,눈과 피부 노래짐,황색증
권태감:무기력,피로감,지침,몸이 무거움,무력감
점액변:끈적한 변,점액이 섞인 변,묽은 변,점액질 변,끈적한 대변
손발을 계속 움직임:손발 가만두지 않음,손발 떨림,손발 쉼없이 움직임,손발 끊임없이 움직임,손발이 멈추지 않음
환부의 분비물:상처 분비물,환부의 고름,상처에서 나오는 것,환부에서 나옴,상처 고름
이인증:현실감 상실,비현실감,자기 분리감,현실과 동떨어짐,자기 이탈감
증상의 일중변동:하루 중 증상 변동,일중 증상 변화,하루 증상 변화,일중 증상 차이,증상의 하루 변화
변비:대변 못봄,변 못 봄,배변 어려움,변비증,변비 증상
실신:기절,졸도,정신 잃음,갑자기 의식 소실,정신 나감
붉은 색소 침착:피부 붉게 변함,붉은 색 피부,피부 붉어짐,붉은 반점,피부색 변화
과호흡:숨을 헐떡임,과하게 숨 쉼,과다 호흡,호흡 가빠짐,과하게 숨 참
한쪽 입 꼬리의 상승:한쪽 입 올라감,한쪽 입꼬리 올라감,한쪽만 웃음,입 한쪽 올라감,한쪽 입꼬리 올라짐
목 주변 부종:목 붓기,목 주변 붓기,목이 부음,목이 붓는 증상,목 주위 부종
가슴 두근거림:심장 두근거림,가슴 떨림,가슴이 두근거림,심장이 두근거림,가슴이 뛰는 느낌
침침함:시야 흐림,눈이 침침함,눈 침침,시력 저하,눈 흐릿함
태아 심박동수 이상:태아 심박 이상,태아 심박 문제,태아 심장 박동 문제,태아 심장 문제,태아 박동수 문제
서호흡:천천히 숨 쉼,느린 호흡,숨 천천히 쉼,천천히 숨 들이마심,느린 숨
하악전돌:아래턱 돌출,턱이 앞으로 나옴,아래턱 앞으로,돌출된 턱,아래턱 튀어나옴
아랫배가 뭉침:아랫배 뻐근함,아랫배 뭉친 느낌,배가 뭉침,아랫배 뻐근,아랫배 경직
불규칙호흡:호흡 불규칙,고르지 않은 숨,불규칙 숨쉬기,숨 불규칙,고르지 못한 호흡
코막힘:막힌 코,코가 막힘,숨쉬기 힘듦,답답한 코,코 막힌 느낌
스푼형 손톱:움푹 팬 손톱,숟가락 손톱,오목한 손톱,패인 손톱,오목형 손톱
골다공증:뼈 약해짐,골밀도 감소,뼈 부서짐,뼈 쉽게 부러짐,약한 뼈
하지의 근력약화:다리 힘 약함,다리 근력 저하,다리 힘 없음,다리 약해짐,하지 근력 저하
불규칙한 반흔:불규칙한 흉터,고르지 않은 흉터,고르지 않은 반흔,불규칙 흉터,불균형 흉터
이물감:낀 느낌,이물질 느낌,꺼끌함,거슬림,이상한 느낌
낮 시간대의 졸음:낮에 졸림,주간 졸림,낮에 잠 옴,낮잠 증상,낮시간 졸림
숨막히는 느낌:질식감,숨막힘,가슴 답답함,숨참,숨 가쁨
복부 불편감:배 불편함,복부 불편,배가 거북함,배 불편,복부 답답함
서맥:느린 맥박,맥박 느림,천천히 뛰는 심장,느린 심박수,느린 심장박동
이상행동:특이 행동,별난 행동,비정상 행동,이상한 행동,이상한 짓
가슴 답답:답답한 가슴,가슴 막힘,가슴이 무거움,가슴이 답답함,가슴 속 막힘
감각 과민:과도한 감각,민감한 감각,과민증,예민한 감각,과한 감각
깨어나면 기억하지 못함:잠깨면 기억 안 남,기억 못함,기억 상실,잠깨면 잊어버림,기억 잃음
음낭이 작아 보임:작아진 음낭,음낭 크기 감소,작은 음낭,줄어든 음낭,작아진 생식기
레이노이드 현상:손발 냉증,혈액순환 문제,손발 창백해짐,혈류 저하,손발 시림
파열부위 오목해짐:파열된 부분 들어감,파열된 곳 오목해짐,들어간 상처,파인 파열부위,오목한 파열 부위
배변장애:변 보기 어려움,배변 문제,변비와 설사,배변 곤란,변 못봄
폐색전:폐 혈전,폐에 혈전,폐 막힘,폐 혈관 막힘,폐 색전증
서동:느린 동작,동작 느림,느린 움직임,행동 느림,천천히 움직임
후비루:목뒤로 넘어가는 콧물,뒤로 흐르는 콧물,목뒤 콧물,후방 콧물,목구멍 콧물
얼굴이 화끈거림:얼굴 뜨거움,얼굴 화끈함,얼굴 붉어짐,얼굴이 화끈거림,얼굴 화끈화끈
광시증:눈 앞 번쩍임,번쩍이는 빛,눈앞에 빛,눈부심,번쩍거림
뼈의 기형:뼈 변형,기형 뼈,뼈 구조 이상,뼈 모양 이상,비정상 뼈
충동적 도벽:갑작스러운 절도,충동적 절도,훔치고 싶은 충동,절도 충동,도벽 충동
신발 안쪽이 주로 닳음:신발 안쪽 마모,신발 안쪽 닳아짐,신발 안쪽 닳음,신발 안쪽 헐음,신발 안쪽 마멸
다모증:과다한 털,과도한 털,털 많음,털 많이 남,많은 털
삐뚤어진 눈:비뚤어진 시선,휘어진 눈,눈이 삐뚤어짐,잘못된 눈,삐딱한 눈
유두부종:부은 유두,유두가 부음,유두 부기,유두 팽창,유두가 커짐
환시:보이는 환상,허상,눈앞 환상,잘못된 시각,눈속임
의식 변화:정신 변화,의식의 변화,정신의 변화,의식 상태 변화,정신 상태 변화
다식:많이 마심,많이 먹음,과도한 갈증,과도한 식욕,지나친 갈증
낭종:물혹,낭포,작은 종양,주머니 종양,혹
자궁이 없음:자궁 결손,자궁 부재,자궁 결여,무자궁,자궁 형성 안됨
눈가 및 이마 주름:눈가 주름,이마 주름,눈가와 이마의 주름,눈가 이마 주름,주름살
야뇨증:밤에 소변봄,야간 소변,밤에 자주 소변,야간 배뇨,밤중 소변
몸살:온몸 아픔,몸이 쑤심,전신 통증,몸 아픔,몸이 찌뿌둥함
반사회적 인격장애:반사회적 성격,사회적 부적응,반사회적 행동,비사회적 성격,반사회 성격
헛기침:빈기침,가짜 기침,가벼운 기침,목 헛기침,헛된 기침
저혈당:혈당 낮음,낮은 혈당,저혈당증,당 떨어짐,혈당 부족
심인성 쇼크:정신적 쇼크,심리적 충격,정신적 충격,심리적 쇼크,심인 쇼크
두통:머리 아픔,두통 증상,머리 통증,아픈 머리,머리가 쑤심
악성종양발생:암 발생,악성 종양,암 생성,암 발달,종양 발생
화농성 비루:고름 콧물,농성 콧물,고름 섞인 콧물,화농 콧물,화농된 콧물
뇌전증 발작:간질 발작,뇌 발작,뇌전증 증상,간질 증상,발작 증상
터널시야:시야 좁아짐,좁아진 시야,터널처럼 보임,시야가 터널처럼,좁아진 시각
읽으려 하지 않음:독서 회피,책 읽기 싫어함,독서 기피,읽기 꺼림,독서 안 함
얼굴 중심선이 안맞음: 얼굴 비대칭, 얼굴 비대칭성, 얼굴 균형 안맞음, 얼굴 중심선 비대칭, 비대칭 얼굴
이가 시림:시린 이,치아 시림,이가 시큰거림,시린 치아,치아 시큰거림
귀 모양의 변형:귀 변형,변형된 귀,귀의 형태 변화,비정상 귀,귀 형태 변형
철결핍성 빈혈:철분 부족 빈혈,철분 결핍 빈혈,철결핍성 빈혈 증상,철 부족 빈혈,철분 결핍 증상
동공이 흰빛으로 반짝임:흰빛 동공,동공 반짝임,흰색 동공,동공이 빛남,빛나는 동공
색소 침착:피부색 변화,피부 색소침착,피부 색소 증가,색소 변화,피부 색소 문제
손가락으로 밀면 들어감:눌러지는 피부,눌리면 들어감,누르면 들어감,손가락에 눌림,피부 눌림
육아조직:새살,새로 자란 조직,새살 조직,재생 조직,새로 난 살
삐뚤어진 눈 코 입:비뚤어진 얼굴, 얼굴 비대칭, 틀어진 눈 코 입, 얼굴 비뚤어짐, 비대칭적인 얼굴
눈이나 뺨 주위 작은 낭종:작은 얼굴 낭종, 얼굴에 생긴 작은 혹, 눈 주위 낭종, 뺨 주위 작은 혹, 얼굴에 생긴 작은 종기
볼과 눈주위 움푹 꺼짐:볼과 눈 주변 함몰, 눈과 뺨의 꺼짐, 눈 주변과 볼의 움푹함, 꺼진 눈과 뺨, 움푹 꺼진 눈 주변과 볼
원형 및 타원형의 탈모:둥근 탈모, 타원형 탈모, 원형 탈모, 타원형의 머리 빠짐, 원형으로 나는 탈모
남아 9세 전 2차 성징:아홉 살 이전의 남아 사춘기, 조기 사춘기 남아, 9세 전 남아 성징, 빠른 사춘기 남자아이, 이른 남아 성징
여아 8세 전 2차 성징:여덟 살 이전의 여아 사춘기, 조기 사춘기 여아, 8세 전 여아 성징, 빠른 사춘기 여자아이, 이른 여아 성징
태아 뼈 또는 근육의 기형:태아 뼈 기형, 태아 근육 기형, 태아 골격 이상, 태아 근육 이상, 태아의 뼈와 근육 문제
음낭에 없는 고환 또는 부고환:음낭 없는 고환, 음낭 없는 부고환, 음낭 내 고환 없음, 음낭 내 부고환 없음, 음낭에서 빠진 고환
입술 및 입천장의 기형:입술 기형, 입천장 기형, 구순 구개열, 갈라진 입술과 입천장, 입과 입천장의 이상
손 발 겨드랑이 발한:손 발 땀, 겨드랑이 땀, 과도한 손발 땀, 손발과 겨드랑이 땀, 땀이 많은 손발 겨드랑이
읽기 쓰기 능력 부족:읽기 어려움, 쓰기 어려움, 읽기 쓰기 문제, 읽기 쓰기 장애, 독해와 작문 어려움